baX-seksdiit_bekwdiit	baX-seksdiit	X;IN:ROOT;IN:PL;IN:3PL.II;OUT:ROOT;OUT:PL;OUT:3PL.II
laX'ut_hlis	laXu	X;IN:ROOT;IN:3.II;OUT:ROOT
'witxw_disekst	bekwt	X;IN:ROOT;OUT:ROOT;OUT:PL;OUT:3.II
gipaygum_hahle'lsdiit	gipaykwdiit	X;IN:ROOT;IN:ATTR;OUT:ROOT;OUT:3PL.II
'masi'y_'wiidaX	limXs	X;IN:ROOT;IN:1SG.II;OUT:ROOT;OUT:PL
nigwoot_xhliiguut	nigwoott	X;IN:ROOT;OUT:ROOT;OUT:3.II
GaGoott_nooGa'y	Goodi'y	X;IN:ROOT;IN:PL;IN:3.II;OUT:ROOT;OUT:1SG.II
ha'wit_t'agi'y	ha'wi'y	X;IN:ROOT;IN:3.II;OUT:ROOT;OUT:1SG.II
gipaykw_t'aham	gipaygum	X;IN:ROOT;IN:PL;OUT:ROOT;OUT:ATTR
ha'wi'y_do'ot	ha'wit	X;IN:ROOT;IN:1SG.II;OUT:ROOT;OUT:3.II
Xsdaadiit_masxwit	Xsdaat	X;IN:ROOT;IN:3PL.II;OUT:ROOT;OUT:SX
'witxwit_K'aKt	'witxwt	X;IN:ROOT;IN:SX;OUT:ROOT;OUT:3.II
K'otsdiit_ha'widint	K'otst	X;IN:ROOT;IN:3PL.II;OUT:ROOT;OUT:3.II
hoo_Xa'nii'y	hooyi'y	X;IN:ROOT;OUT:ROOT;OUT:TR;OUT:1SG.II
huwilpt_gwilain	wilp	X;IN:ROOT;IN:PL;IN:3.II;OUT:ROOT
went_am'amit	went	X;IN:ROOT;IN:PL;IN:3.II;OUT:ROOT;OUT:PL;OUT:SX
baGa'y_sinhunt	baKt	X;IN:ROOT;IN:TR;IN:1SG.II;OUT:ROOT;OUT:3.II
'mas_he'y	'masi'y	X;IN:ROOT;OUT:ROOT;OUT:1SG.II
hedindiit_luusgit	hidint	X;IN:ROOT;IN:3PL.II;OUT:ROOT;OUT:3.II
laXyip_algaXa'm	laXyibi'm	X;IN:ROOT;OUT:ROOT;OUT:1PL.II
am_hlo'ot	am'amit	X;IN:ROOT;OUT:ROOT;OUT:PL;OUT:SX
ga'a'y_Xmaa'yi'm	ga'a'm	X;IN:ROOT;IN:1SG.II;OUT:ROOT;OUT:1PL.II
giihli'y_bagu'm	laahli'm	X;IN:ROOT;IN:1SG.II;OUT:ROOT;OUT:PL;OUT:1PL.II
masxwt_sGoo	mesxw	X;IN:ROOT;IN:3.II;OUT:ROOT
want_luujoGat	t'aat	X;IN:ROOT;IN:PL;IN:3.II;OUT:ROOT;OUT:SX
het_aamit	heet	X;IN:ROOT;IN:3.II;OUT:ROOT;OUT:SX
limixi'm_hasaK	lim	X;IN:ROOT;IN:1PL.II;OUT:ROOT
t'aat_mihas'us	wan	X;IN:ROOT;IN:SX;OUT:ROOT;OUT:PL
hlo'odiit_dildilsit	hlo'ot	X;IN:ROOT;IN:PL;IN:3PL.II;OUT:ROOT;OUT:PL;OUT:SX
yuxwdiit_silim	yuxw	X;IN:ROOT;IN:3PL.II;OUT:ROOT
dohot_hapdiit	sgidiit	X;IN:ROOT;IN:PL;IN:SX;OUT:ROOT;OUT:3PL.II
aluut'aat_hets	aluut'aa	X;IN:ROOT;IN:3.II;OUT:ROOT
wilaaxt_ga'at	wilaayit	X;IN:ROOT;IN:3.II;OUT:ROOT;OUT:TR;OUT:3.II
noX_gedi'y	noXo'y	X;IN:ROOT;OUT:ROOT;OUT:1SG.II
bagu'm_t'am	'witxw	X;IN:ROOT;IN:PL;IN:1PL.II;OUT:ROOT
'nagwit_didalK	'nakw	X;IN:ROOT;IN:SX;OUT:ROOT
t'ahl_da'aKhlxwdiit	maKdiit	X;IN:ROOT;IN:PL;OUT:ROOT;OUT:3PL.II
gindiit_Gaseexwt	gint	X;IN:ROOT;IN:3PL.II;OUT:ROOT;OUT:3.II
jabit_Xa'nii'y	jabi'y	X;IN:ROOT;IN:TR;IN:3.II;OUT:ROOT;OUT:TR;OUT:1SG.II
gidaXa'm_saK'apdiit	gidaXdiit	X;IN:ROOT;IN:1PL.II;OUT:ROOT;OUT:3PL.II
ama_sekst	am'amt	X;IN:ROOT;IN:ATTR;OUT:ROOT;OUT:PL;OUT:3.II
heldim_ant'aahl	helt	X;IN:ROOT;IN:ATTR;OUT:ROOT
jaXjoKdiit_dexwit	jaXjoGat	X;IN:ROOT;IN:PL;IN:3PL.II;OUT:ROOT;OUT:PL;OUT:SX
dexw_gipaykwt	dexwt	X;IN:ROOT;IN:PL;OUT:ROOT;OUT:PL;OUT:3.II
seksit_liiluxwdiit	seksdiit	X;IN:ROOT;IN:PL;IN:SX;OUT:ROOT;OUT:PL;OUT:3PL.II
daha'wdiit_xdaa	diha'w	X;IN:ROOT;IN:3PL.II;OUT:ROOT
aluut'aa_hanaK't	aluut'aat	X;IN:ROOT;OUT:ROOT;OUT:3.II
ban_haboo'lt	bent	X;IN:ROOT;OUT:ROOT;OUT:3.II
guseeKt_hlo'ot	gwiiseeKt	X;IN:ROOT;IN:3.II;OUT:ROOT;OUT:PL;OUT:3.II
laXyip_silkwt	laXyipt	X;IN:ROOT;OUT:ROOT;OUT:3.II
saGaytGootdiit_hlo'odiit	saGaytGootdiit	X;IN:ROOT;IN:3PL.II;OUT:ROOT;OUT:3PL.II
wan_huwilaa	wen	X;IN:ROOT;IN:PL;OUT:ROOT;OUT:PL
hogaXdiit_t'aam	hogaXam	X;IN:ROOT;IN:3PL.II;OUT:ROOT;OUT:ATTR
joK_ts'ehlXdiit	joKdiit	X;IN:ROOT;OUT:ROOT;OUT:3PL.II
halaaxdiit_nakst	halaaxt	X;IN:ROOT;IN:3PL.II;OUT:ROOT;OUT:3.II
Goot_luuwendiit	GaGootdiit	X;IN:ROOT;OUT:ROOT;OUT:PL;OUT:3PL.II
gubit_yukw	gup	X;IN:ROOT;IN:TR;IN:3.II;OUT:ROOT
laXyibi'm_ayooKdiit	laXyipdiit	X;IN:ROOT;IN:1PL.II;OUT:ROOT;OUT:3PL.II
Gootdiit_algaXa'm	Goodi'm	X;IN:ROOT;IN:3PL.II;OUT:ROOT;OUT:1PL.II
hlimoot_Gabidiit	hlimoodiit	X;IN:ROOT;IN:3.II;OUT:ROOT;OUT:3PL.II
wili'y_k'i'yt	wilt	X;IN:ROOT;IN:1SG.II;OUT:ROOT;OUT:SX
hlguuhlxw_gwalgwa	hlguuhlxum	X;IN:ROOT;OUT:ROOT;OUT:ATTR
iksdet_baXyuxw	iksde	X;IN:ROOT;IN:3.II;OUT:ROOT
didelKt_jebin	didalGan	X;IN:ROOT;IN:3.II;OUT:ROOT;OUT:TR;OUT:2SG.II
GaGoott_lukwt	Goott	X;IN:ROOT;IN:PL;IN:3.II;OUT:ROOT;OUT:3.II
wandiit_hlgit	want	X;IN:ROOT;IN:PL;IN:3PL.II;OUT:ROOT;OUT:PL;OUT:3.II
joGot_tXooGandiit	jaXjoKdiit	X;IN:ROOT;IN:SX;OUT:ROOT;OUT:PL;OUT:3PL.II
lim_hlo'o'm	limixi'm	X;IN:ROOT;OUT:ROOT;OUT:1PL.II
hlo'ot_jaXjoGo'm	hlo'o'm	X;IN:ROOT;IN:PL;IN:3.II;OUT:ROOT;OUT:PL;OUT:1PL.II
win_nigwoodi'm	wili'm	X;IN:ROOT;IN:2SG.II;OUT:ROOT;OUT:1PL.II
gi'namt_gi'nami'y	gi'nami'y	X;IN:ROOT;IN:3.II;OUT:ROOT;OUT:TR;OUT:1SG.II
dexwt_heldit	'nu'wt	X;IN:ROOT;IN:PL;IN:3.II;OUT:ROOT;OUT:SX
jipjepdiit_saGaytGoodat	jept	X;IN:ROOT;IN:PL;IN:3PL.II;OUT:ROOT;OUT:3.II
hooxt_gubi'y	hooyi'y	X;IN:ROOT;IN:3.II;OUT:ROOT;OUT:TR;OUT:1SG.II
tk'ihlxum_gemgim	t'ihlxum	X;IN:ROOT;IN:ATTR;OUT:ROOT;OUT:ATTR
hlgidiit_ts'ini'y	hlguuhlxwi'y	X;IN:ROOT;IN:PL;IN:3PL.II;OUT:ROOT;OUT:1SG.II
jaXjoGot_hahle'lsdiit	joKdiit	X;IN:ROOT;IN:PL;IN:SX;OUT:ROOT;OUT:3PL.II
ayukws_bitxum	ayukwsim	X;IN:ROOT;OUT:ROOT;OUT:ATTR
ts'ini'y_kw'ootin	ts'in	X;IN:ROOT;IN:1SG.II;OUT:ROOT
amt_dohot	am'amit	X;IN:ROOT;IN:3.II;OUT:ROOT;OUT:PL;OUT:SX
jabi'y_lidindiit	jipjepdiit	X;IN:ROOT;IN:TR;IN:1SG.II;OUT:ROOT;OUT:PL;OUT:3PL.II
he_huksin	hen	X;IN:ROOT;OUT:ROOT;OUT:2SG.II
sit'aadiit_wandiit	siwendiit	X;IN:ROOT;IN:3PL.II;OUT:ROOT;OUT:PL;OUT:3PL.II
gi'namdiit_'witxwt	gi'namt	X;IN:ROOT;IN:3PL.II;OUT:ROOT;OUT:3.II
begu'm_huutt	bekwt	X;IN:ROOT;IN:PL;IN:1PL.II;OUT:ROOT;OUT:PL;OUT:3.II
saGaytGootda_gitxsdiit	saGaytGootdiit	X;IN:ROOT;IN:3PL;OUT:ROOT;OUT:3PL.II
wilaaxdiit_haanaK'	huwilaa	X;IN:ROOT;IN:3PL.II;OUT:ROOT;OUT:PL
'witxwi'y_lit	bakw	X;IN:ROOT;IN:1SG.II;OUT:ROOT;OUT:PL
dibegwit_dexwt	dibekwt	X;IN:ROOT;IN:PL;IN:TR;IN:3.II;OUT:ROOT;OUT:PL;OUT:3.II
mihas'us_he'y	ma'usi'y	X;IN:ROOT;IN:PL;OUT:ROOT;OUT:1SG.II
wisi'm_saGaytGootda	wilda	X;IN:ROOT;IN:2PL.II;OUT:ROOT;OUT:3PL
t'amt_nigwoot	t'am	X;IN:ROOT;IN:3.II;OUT:ROOT
gigi'ydiit_joKt	gi'yt	X;IN:ROOT;IN:PL;IN:3PL.II;OUT:ROOT;OUT:3.II
het_t'aan	hen	X;IN:ROOT;IN:3.II;OUT:ROOT;OUT:2SG.II
t'aat_hlaahlaXtt	want	X;IN:ROOT;IN:SX;OUT:ROOT;OUT:PL;OUT:3.II
daXgadim_hloXsa	daXgadim	X;IN:ROOT;IN:ATTR;OUT:ROOT;OUT:ATTR
aamit_huwelixim	am'ama	X;IN:ROOT;IN:SX;OUT:ROOT;OUT:PL;OUT:ATTR
sgett_ts'eet	sgett	X;IN:ROOT;IN:3.II;OUT:ROOT;OUT:3.II
ga'at_doKdiit	gitga'adiit	X;IN:ROOT;IN:TR;IN:3.II;OUT:ROOT;OUT:PL;OUT:3PL.II
t'ilXoo'y_ayooKdiit	t'ilXo'odiit	X;IN:ROOT;IN:1SG.II;OUT:ROOT;OUT:3PL.II
limXsim_hlguuhlxum	'mesim	X;IN:ROOT;IN:PL;IN:ATTR;OUT:ROOT;OUT:ATTR
wadiit_office	we	X;IN:ROOT;IN:3PL.II;OUT:ROOT
baX_we'y	baXa'y	X;IN:ROOT;OUT:ROOT;OUT:1SG.II
hlimoo'm_mail	hlimoo	X;IN:ROOT;IN:1PL.II;OUT:ROOT
t'aat_gwilan	t'aan	X;IN:ROOT;IN:3.II;OUT:ROOT;OUT:2SG.II
neksim_Xpts'exw	neks	X;IN:ROOT;IN:ATTR;OUT:ROOT
maKt_huwilaa	t'ahl	X;IN:ROOT;IN:3.II;OUT:ROOT;OUT:PL
saGaytwendiit_loodiit	saGaytwendiit	X;IN:ROOT;IN:PL;IN:3PL.II;OUT:ROOT;OUT:PL;OUT:3PL.II
t'aX_jayeehlt	t'aXt	X;IN:ROOT;OUT:ROOT;OUT:3.II
'wiidaX_mismesxw	'waat'aX	X;IN:ROOT;IN:PL;OUT:ROOT;OUT:PL
noXdiit_wegi'y	noXo'y	X;IN:ROOT;IN:3PL.II;OUT:ROOT;OUT:1SG.II
amit_xsiga'a	am	X;IN:ROOT;IN:SX;OUT:ROOT
hapdiit_hooyit	tK'esxwit	X;IN:ROOT;IN:PL;IN:3PL.II;OUT:ROOT;OUT:TR;OUT:3.II
wandiit_hapdiit	wendiit	X;IN:ROOT;IN:PL;IN:3PL.II;OUT:ROOT;OUT:PL;OUT:3PL.II
want_yuxwt	t'aat	X;IN:ROOT;IN:PL;IN:3.II;OUT:ROOT;OUT:3.II
jep_Xbaa'wt	japt	X;IN:ROOT;OUT:ROOT;OUT:3.II
t'am_k'etsxwdiit	t'amdiit	X;IN:ROOT;OUT:ROOT;OUT:3PL.II
wiyitxw_gi'namt	wiyitxwt	X;IN:ROOT;OUT:ROOT;OUT:3.II
Xa'nit_ha'wit	naX'nit	X;IN:ROOT;IN:3.II;OUT:ROOT;OUT:3.II
loGa_gi'namhlxum	loGom	X;IN:ROOT;IN:ATTR;OUT:ROOT;OUT:ATTR
bagu'm_jaXjoKt	bekwt	X;IN:ROOT;IN:PL;IN:1PL.II;OUT:ROOT;OUT:PL;OUT:3.II
jehl_gi'namit	jehlit	X;IN:ROOT;OUT:ROOT;OUT:TR;OUT:3.II
t'aat_dibakwdiit	wandiit	X;IN:ROOT;IN:3.II;OUT:ROOT;OUT:PL;OUT:3PL.II
huwilaa_jebisi'm	wilaayisi'm	X;IN:ROOT;IN:PL;OUT:ROOT;OUT:TR;OUT:2PL.II
hen_baGadilt	heet	X;IN:ROOT;IN:2SG.II;OUT:ROOT;OUT:SX
baGadilda_laXyibi'm	baGadili'm	X;IN:ROOT;IN:3PL;OUT:ROOT;OUT:1PL.II
wegi'y_ant'aahl	wa	X;IN:ROOT;IN:1SG.II;OUT:ROOT
dexw_giihlt	'nu'wt	X;IN:ROOT;IN:PL;OUT:ROOT;OUT:3.II
didalK_yuxwt	didelKt	X;IN:ROOT;OUT:ROOT;OUT:3.II
hlgi_Goldiit	hlgidiit	X;IN:ROOT;IN:PL;OUT:ROOT;OUT:PL;OUT:3PL.II
Galts'ap_baXyuxwdiithl	Galts'epdiit	X;IN:ROOT;OUT:ROOT;OUT:3PL.II
hooyit_hapdiit	hooxdiit	X;IN:ROOT;IN:TR;IN:3.II;OUT:ROOT;OUT:3PL.II
helda_K'otsdiit	heltdiit	X;IN:ROOT;IN:ATTR;OUT:ROOT;OUT:3PL.II
hlimoot_Xmaa'yi'm	hlimoo'm	X;IN:ROOT;IN:3.II;OUT:ROOT;OUT:1PL.II
luuwendiit_saabekwt	luuwent	X;IN:ROOT;IN:PL;IN:3PL.II;OUT:ROOT;OUT:PL;OUT:3.II
algaXa'm_ksi'wadiit	algaXdiit	X;IN:ROOT;IN:1PL.II;OUT:ROOT;OUT:3PL.II
japdiit_t'amin	jebin	X;IN:ROOT;IN:3PL.II;OUT:ROOT;OUT:TR;OUT:2SG.II
t'e_gi'nami'y	t'agi'y	X;IN:ROOT;OUT:ROOT;OUT:TR;OUT:1SG.II
t'aam_iwit	t'aat	X;IN:ROOT;IN:ATTR;OUT:ROOT;OUT:SX
ha'u'm_limixi'm	ha'wi'm	X;IN:ROOT;IN:1PL.II;OUT:ROOT;OUT:1PL.II
hisyetst_hlenin	yets	X;IN:ROOT;IN:PL;IN:3.II;OUT:ROOT
jep_t'amin	jebin	X;IN:ROOT;OUT:ROOT;OUT:TR;OUT:2SG.II
hahle'lsdiit_Galts'ebi'm	hahle'lsdi'm	X;IN:ROOT;IN:3PL.II;OUT:ROOT;OUT:1PL.II
amhalaytt_luutK'alno'o	amhalayt	X;IN:ROOT;IN:3.II;OUT:ROOT
went_gigitxsit	want	X;IN:ROOT;IN:PL;IN:3.II;OUT:ROOT;OUT:PL;OUT:SX
yuxwdiit_haboo'lt	yuxwt	X;IN:ROOT;IN:3PL.II;OUT:ROOT;OUT:3.II
hahlo'ot_dit'aX	hahlo'o	X;IN:ROOT;IN:PL;IN:3.II;OUT:ROOT;OUT:PL
hlgim_Xbits'iixw	hlgi	X;IN:ROOT;IN:PL;IN:ATTR;OUT:ROOT;OUT:PL
daXgat_a'laXa'm	daXgedi'm	X;IN:ROOT;OUT:ROOT;OUT:1PL.II
hasaGa'm_Gant	hasaKt	X;IN:ROOT;IN:1PL.II;OUT:ROOT;OUT:3.II
nekst_amGoot	nakst	X;IN:ROOT;IN:3.II;OUT:ROOT;OUT:3.II
'wiiyitxwt_baKdiit	wiyitxwdiit	X;IN:ROOT;IN:3.II;OUT:ROOT;OUT:3PL.II
ban_tK'esxwt	bant	X;IN:ROOT;OUT:ROOT;OUT:3.II
daXgadim_eets	daXgat	X;IN:ROOT;IN:ATTR;OUT:ROOT
wilt_hasaGat	wilt	X;IN:ROOT;IN:3.II;OUT:ROOT;OUT:SX
se'e_kw'asint	se'et	X;IN:ROOT;OUT:ROOT;OUT:3.II
noXo'm_'masi'y	noho'y	X;IN:ROOT;IN:1PL.II;OUT:ROOT;OUT:1SG.II
hets_hapdiit	hashetsdiit	X;IN:ROOT;OUT:ROOT;OUT:PL;OUT:3PL.II
t'aat_ama	t'aam	X;IN:ROOT;IN:SX;OUT:ROOT;OUT:ATTR
Xa'nit_Goodat	naX'nit	X;IN:ROOT;IN:3.II;OUT:ROOT;OUT:3.II
wen_lixleyit	wanit	X;IN:ROOT;IN:PL;OUT:ROOT;OUT:PL;OUT:SX
t'imGes_adaawKt	t'imGest	X;IN:ROOT;OUT:ROOT;OUT:3.II
yuwit_baasxi'y	yuwi'y	X;IN:ROOT;IN:TR;IN:3.II;OUT:ROOT;OUT:TR;OUT:1SG.II
waatxw_wineext	waatxwt	X;IN:ROOT;OUT:ROOT;OUT:3.II
ga'at_hlguuhlxw	ga'a	X;IN:ROOT;IN:3.II;OUT:ROOT
hlo'ot_a'laXt	yeet	X;IN:ROOT;IN:PL;IN:3.II;OUT:ROOT;OUT:3.II
gitga'adiit_saGaytGoodint	ga'at	X;IN:ROOT;IN:PL;IN:3PL.II;OUT:ROOT;OUT:3.II
jebisi'm_guxwin	jebin	X;IN:ROOT;IN:TR;IN:2PL.II;OUT:ROOT;OUT:TR;OUT:2SG.II
hlo'ot_siwen	hlo'o	X;IN:ROOT;IN:PL;IN:SX;OUT:ROOT;OUT:PL
hugwaX_k'apt	hugwaXt	X;IN:ROOT;OUT:ROOT;OUT:3.II
t'aXt_baGadilim	t'aham	X;IN:ROOT;IN:3.II;OUT:ROOT;OUT:ATTR
t'aan_gigitxsit	went	X;IN:ROOT;IN:2SG.II;OUT:ROOT;OUT:PL;OUT:SX
hlimoo'ldiit_gwiladint	hlimoo'ltt	X;IN:ROOT;IN:3PL.II;OUT:ROOT;OUT:3.II
am'amt_hloXsa	ama	X;IN:ROOT;IN:PL;IN:3.II;OUT:ROOT;OUT:ATTR
hlimoo'lt_yuxwdiit	hlimoo'ldiit	X;IN:ROOT;OUT:ROOT;OUT:3PL.II
'mesim_noho'y	'mesi'y	X;IN:ROOT;IN:ATTR;OUT:ROOT;OUT:1SG.II
guts'uusgi'y_ga'a'm	hlguts'uusgi'm	X;IN:ROOT;IN:1SG.II;OUT:ROOT;OUT:1PL.II
ayukws_simihldiit	ayukwsdiit	X;IN:ROOT;OUT:ROOT;OUT:3PL.II
gi'namit_nigwoott	gi'namt	X;IN:ROOT;IN:TR;IN:3.II;OUT:ROOT;OUT:3.II
hasaK_huksi'y	hasaGa'y	X;IN:ROOT;OUT:ROOT;OUT:1SG.II
jebisi'm_ansdo'o	jep	X;IN:ROOT;IN:TR;IN:2PL.II;OUT:ROOT
hlguuhlxwi'y_mihas'us	hlgi	X;IN:ROOT;IN:1SG.II;OUT:ROOT;OUT:PL
naX'ni_gimxdit	naX'nit	X;IN:ROOT;OUT:ROOT;OUT:3.II
'witxwit_mas'usi'm	bagu'm	X;IN:ROOT;IN:SX;OUT:ROOT;OUT:PL;OUT:1PL.II
gidaX_he'm	gidaXa'm	X;IN:ROOT;OUT:ROOT;OUT:1PL.II
'wadiit_ha'win	'wa	X;IN:ROOT;IN:3PL.II;OUT:ROOT
Gootdiit_Xsiks	Goot	X;IN:ROOT;IN:3PL.II;OUT:ROOT
sekst_hal'olaXat	saksit	X;IN:ROOT;IN:PL;IN:3.II;OUT:ROOT;OUT:PL;OUT:SX
'nu'wt_'niiluxw	dexw	X;IN:ROOT;IN:3.II;OUT:ROOT;OUT:PL
hlguuhlxw_luut'ehldiit	hlgidiit	X;IN:ROOT;OUT:ROOT;OUT:PL;OUT:3PL.II
wisi'm_guts'uusgi'y	wili'y	X;IN:ROOT;IN:2PL.II;OUT:ROOT;OUT:1SG.II
anooKdiit_Goodi'm	anooGo'm	X;IN:ROOT;IN:3PL.II;OUT:ROOT;OUT:1PL.II
'maXst_ama	'maXsim	X;IN:ROOT;IN:3.II;OUT:ROOT;OUT:ATTR
woKt_loo	woowaX	X;IN:ROOT;IN:3.II;OUT:ROOT;OUT:PL
uu'wit_xhliiguu	uu'w	X;IN:ROOT;IN:3.II;OUT:ROOT
hooyi'm_kw'esini'y	hooyi'y	X;IN:ROOT;IN:TR;IN:1PL.II;OUT:ROOT;OUT:TR;OUT:1SG.II
huwilaa_aaKt	halaaxt	X;IN:ROOT;IN:PL;OUT:ROOT;OUT:3.II
wilt_ha'w	wil	X;IN:ROOT;IN:3.II;OUT:ROOT
doKt_dexwt	doKt	X;IN:ROOT;IN:PL;IN:3.II;OUT:ROOT;OUT:PL;OUT:3.II
gyoot_dexw	loo	X;IN:ROOT;IN:3.II;OUT:ROOT;OUT:PL
didalGan_se'e	didalK	X;IN:ROOT;IN:TR;IN:2SG.II;OUT:ROOT
hitin_ant'aat	hidint	X;IN:ROOT;OUT:ROOT;OUT:3.II
saksit_jipjepdiit	seksdiit	X;IN:ROOT;IN:PL;IN:SX;OUT:ROOT;OUT:PL;OUT:3PL.II
t'aat_hloXsa	t'aam	X;IN:ROOT;IN:SX;OUT:ROOT;OUT:ATTR
da'aKhlxw_t'aadindiit	da'aKhlxwdiit	X;IN:ROOT;OUT:ROOT;OUT:3PL.II
am'amit_Ge'n	am	X;IN:ROOT;IN:PL;IN:SX;OUT:ROOT
wanit_dexwit	want	X;IN:ROOT;IN:PL;IN:SX;OUT:ROOT;OUT:PL;OUT:SX
went_'wiidaX	wan	X;IN:ROOT;IN:PL;IN:3.II;OUT:ROOT;OUT:PL
'witxw_mas'usi'm	bagu'm	X;IN:ROOT;OUT:ROOT;OUT:PL;OUT:1PL.II
laahli'm_sit'aa	giihl	X;IN:ROOT;IN:PL;IN:1PL.II;OUT:ROOT
gwalkw_sinhunt	gwelkwt	X;IN:ROOT;OUT:ROOT;OUT:3.II
hlguts'uusgi'm_anjoK	hlguts'uus	X;IN:ROOT;IN:1PL.II;OUT:ROOT
hen_baKdiit	hediit	X;IN:ROOT;IN:2SG.II;OUT:ROOT;OUT:3PL.II
jabit_waatxwdiit	jepdiit	X;IN:ROOT;IN:TR;IN:3.II;OUT:ROOT;OUT:3PL.II
noXo'm_sGat'aat	noXt	X;IN:ROOT;IN:1PL.II;OUT:ROOT;OUT:3.II
ga'a'm_se'et	ga'at	X;IN:ROOT;IN:1PL.II;OUT:ROOT;OUT:3.II
wilaayisi'm_Xa'nii'y	wilaayi'y	X;IN:ROOT;IN:TR;IN:2PL.II;OUT:ROOT;OUT:TR;OUT:1SG.II
limxt_hlguhlguts'uuskts'uus	lim	X;IN:ROOT;IN:3.II;OUT:ROOT
wat_noXo'm	wa'm	X;IN:ROOT;IN:SX;OUT:ROOT;OUT:1PL.II
Gos_Gosi'm	Gosi'm	X;IN:ROOT;OUT:ROOT;OUT:TR;OUT:1PL.II
niinixs_alGalt	nekst	X;IN:ROOT;IN:PL;OUT:ROOT;OUT:3.II
hasaK_wilsi'm	hasaKsi'm	X;IN:ROOT;OUT:ROOT;OUT:2PL.II
laahldiit_loo	laahl	X;IN:ROOT;IN:PL;IN:3PL.II;OUT:ROOT;OUT:PL
get_simgigat	ii'wxwt	X;IN:ROOT;OUT:ROOT;OUT:PL
wiyitsxwdiit_weli	wiyitxw	X;IN:ROOT;IN:3PL.II;OUT:ROOT
wildigitxwdiit_Getxw	wildigitxw	X;IN:ROOT;IN:3PL.II;OUT:ROOT
bekw_mas'usi'm	bagu'm	X;IN:ROOT;IN:PL;OUT:ROOT;OUT:PL;OUT:1PL.II
'witxw_aluugiget	bekw	X;IN:ROOT;OUT:ROOT;OUT:PL
hedindiit_hlgidiit	lidindiit	X;IN:ROOT;IN:3PL.II;OUT:ROOT;OUT:PL;OUT:3PL.II
sgidiit_limXs	doX	X;IN:ROOT;IN:3PL.II;OUT:ROOT;OUT:PL
hap_nigwoott	tK'esxwt	X;IN:ROOT;IN:PL;OUT:ROOT;OUT:3.II
wilda_Go'osi'm	wisi'm	X;IN:ROOT;IN:3PL;OUT:ROOT;OUT:2PL.II
hugwaX_Gootdiit	hogaXdiit	X;IN:ROOT;OUT:ROOT;OUT:3PL.II
didilsdi'm_bekwdiit	dildilsdiit	X;IN:ROOT;IN:PL;IN:1PL.II;OUT:ROOT;OUT:PL;OUT:3PL.II
saksit_jaXjoGat	seksit	X;IN:ROOT;IN:PL;IN:SX;OUT:ROOT;OUT:PL;OUT:SX
wilsi'm_wili'y	wili'y	X;IN:ROOT;IN:2PL.II;OUT:ROOT;OUT:1SG.II
'witxwi'y_saks	bekw	X;IN:ROOT;IN:1SG.II;OUT:ROOT;OUT:PL
saksdiit_jem	daa'whl	X;IN:ROOT;IN:PL;IN:3PL.II;OUT:ROOT
seks_tK'alitt	sekst	X;IN:ROOT;IN:PL;OUT:ROOT;OUT:PL;OUT:3.II
wadiit_Golt	huwat	X;IN:ROOT;IN:3PL.II;OUT:ROOT;OUT:PL;OUT:3.II
hlgi_hlgi'y	hlgi'y	X;IN:ROOT;IN:PL;OUT:ROOT;OUT:PL;OUT:1SG.II
laXyipt_baGadilt	laXyibit	X;IN:ROOT;IN:3.II;OUT:ROOT;OUT:SX
joGo'm_doKt	jaXjoKt	X;IN:ROOT;IN:1PL.II;OUT:ROOT;OUT:PL;OUT:3.II
ayawaatxwt_hlo'odiit	ayawaatxwdiit	X;IN:ROOT;IN:3.II;OUT:ROOT;OUT:3PL.II
limXsim_t'ihlxw	'mas	X;IN:ROOT;IN:PL;IN:ATTR;OUT:ROOT
loGa_gidaXt	loKt	X;IN:ROOT;IN:ATTR;OUT:ROOT;OUT:3.II
japdiit_jipjepdiit	jipjepdiit	X;IN:ROOT;IN:3PL.II;OUT:ROOT;OUT:PL;OUT:3PL.II
noXon_ha'wdiit	noXdiit	X;IN:ROOT;IN:2SG.II;OUT:ROOT;OUT:3PL.II
wat_Xdeyi'm	wa'm	X;IN:ROOT;IN:3.II;OUT:ROOT;OUT:1PL.II
jaXjoKdiit_Ganaa'wi'y	joGo'y	X;IN:ROOT;IN:PL;IN:3PL.II;OUT:ROOT;OUT:1SG.II
silgedi'm_yuuhlimXdiit	silgetdiit	X;IN:ROOT;IN:1PL.II;OUT:ROOT;OUT:3PL.II
aamit_didelKt	amt	X;IN:ROOT;IN:SX;OUT:ROOT;OUT:3.II
Goldiit_'yens	baX	X;IN:ROOT;IN:PL;IN:3PL.II;OUT:ROOT
Galts'epdiit_gidaXa'm	Galts'ebi'm	X;IN:ROOT;IN:3PL.II;OUT:ROOT;OUT:1PL.II
is_sdik'eegwin	isin	X;IN:ROOT;OUT:ROOT;OUT:2SG.II
baXa'y_wilpt	baXt	X;IN:ROOT;IN:1SG.II;OUT:ROOT;OUT:3.II
bekwdiit_laahli'm	begu'm	X;IN:ROOT;IN:PL;IN:3PL.II;OUT:ROOT;OUT:PL;OUT:1PL.II
Goot_noXt	Goott	X;IN:ROOT;OUT:ROOT;OUT:3.II
wildiit_loKt	wilt	X;IN:ROOT;IN:3PL.II;OUT:ROOT;OUT:3.II
huut_bekwdiit	huutdiit	X;IN:ROOT;IN:PL;OUT:ROOT;OUT:PL;OUT:3PL.II
GaGoott_laXyibi'm	Goodi'm	X;IN:ROOT;IN:PL;IN:3.II;OUT:ROOT;OUT:1PL.II
t'ehldiit_tXooK	t'ehl	X;IN:ROOT;IN:PL;IN:3PL.II;OUT:ROOT;OUT:PL
joK_jaXjoGat	jaXjoGot	X;IN:ROOT;OUT:ROOT;OUT:PL;OUT:SX
noX_aX'algaGa'y	noho'y	X;IN:ROOT;OUT:ROOT;OUT:1SG.II
gipaykwt_XsdemGam	gipaygum	X;IN:ROOT;IN:3.II;OUT:ROOT;OUT:ATTR
t'ilXo'odiit_t'ilXo'odiit	t'ilXo'odiit	X;IN:ROOT;IN:3PL.II;OUT:ROOT;OUT:3PL.II
jebisi'm_baGa'y	jebi'y	X;IN:ROOT;IN:TR;IN:2PL.II;OUT:ROOT;OUT:TR;OUT:1SG.II
aliisxu'm_sinhun	alisxw	X;IN:ROOT;IN:PL;IN:1PL.II;OUT:ROOT
hlgit_huudindiit	hlgidiit	X;IN:ROOT;IN:PL;IN:3.II;OUT:ROOT;OUT:PL;OUT:3PL.II
hitin_laahldiit	lidindiit	X;IN:ROOT;OUT:ROOT;OUT:PL;OUT:3PL.II
'nu'wt_saabekwt	dexwt	X;IN:ROOT;IN:SX;OUT:ROOT;OUT:PL;OUT:3.II
wendiit_sgit	t'aat	X;IN:ROOT;IN:PL;IN:3PL.II;OUT:ROOT;OUT:SX
ha'u'm_office'y	ha'wi'y	X;IN:ROOT;IN:1PL.II;OUT:ROOT;OUT:1SG.II
K'amksiwaamXdiit_hapdiit	K'amksiwaamXdiit	X;IN:ROOT;IN:3PL.II;OUT:ROOT;OUT:3PL.II
dikw'itxw_jisjahlit	dibegwit	X;IN:ROOT;OUT:ROOT;OUT:PL;OUT:TR;OUT:3.II
daha'wit_t'isdiit	daha'wdiit	X;IN:ROOT;IN:3.II;OUT:ROOT;OUT:3PL.II
'alGal_wilpt	alGalt	X;IN:ROOT;OUT:ROOT;OUT:3.II
baX_aliisxu'm	Goli'm	X;IN:ROOT;OUT:ROOT;OUT:PL;OUT:1PL.II
hogaXdiit_aKhlxw	hugwaX	X;IN:ROOT;IN:3PL.II;OUT:ROOT
hasaGat_am	hasaK	X;IN:ROOT;IN:SX;OUT:ROOT
giihlt_joK	giihl	X;IN:ROOT;IN:3.II;OUT:ROOT
jebi'y_wilaayi'y	jabi'y	X;IN:ROOT;IN:TR;IN:1SG.II;OUT:ROOT;OUT:TR;OUT:1SG.II
helda_laXyibit	heldit	X;IN:ROOT;IN:ATTR;OUT:ROOT;OUT:SX
ayukwsim_ha'u'm	ayukwsi'm	X;IN:ROOT;IN:ATTR;OUT:ROOT;OUT:1PL.II
t'ehl_luuwendiit	t'ehldiit	X;IN:ROOT;IN:PL;OUT:ROOT;OUT:PL;OUT:3PL.II
dexw_gigitxsit	dexwit	X;IN:ROOT;IN:PL;OUT:ROOT;OUT:PL;OUT:SX
hlguts'uus_hligu'm	hlguts'uusgi'm	X;IN:ROOT;OUT:ROOT;OUT:1PL.II
'mesim_t'is	'mas	X;IN:ROOT;IN:ATTR;OUT:ROOT
jebisi'm_al'alGaldiit	jipjepdiit	X;IN:ROOT;IN:TR;IN:2PL.II;OUT:ROOT;OUT:PL;OUT:3PL.II
daa'whlit_Xmaa'y	daa'whl	X;IN:ROOT;IN:SX;OUT:ROOT
bekwdiit_wilplaahlt	bekwt	X;IN:ROOT;IN:PL;IN:3PL.II;OUT:ROOT;OUT:PL;OUT:3.II
Galjipts'ep_guxw	Galts'ap	X;IN:ROOT;IN:PL;OUT:ROOT
went_am'amit	wanit	X;IN:ROOT;IN:PL;IN:SX;OUT:ROOT;OUT:PL;OUT:SX
Goot_ayukwsi'm	Goodi'm	X;IN:ROOT;OUT:ROOT;OUT:1PL.II
bitxum_hets	bitxw	X;IN:ROOT;IN:ATTR;OUT:ROOT
alGalt_sget	'alGal	X;IN:ROOT;IN:3.II;OUT:ROOT
dikw'itxw_dibekwt	dibekwt	X;IN:ROOT;OUT:ROOT;OUT:PL;OUT:3.II
he'm_ts'uusgi'y	he'y	X;IN:ROOT;IN:1PL.II;OUT:ROOT;OUT:1SG.II
a'laX_Xa'naayi'm	a'laXa'm	X;IN:ROOT;OUT:ROOT;OUT:1PL.II
doX_'nagwit	sgit	X;IN:ROOT;IN:PL;OUT:ROOT;OUT:SX
ga'a'y_'wayi'm	ga'a'm	X;IN:ROOT;IN:1SG.II;OUT:ROOT;OUT:TR;OUT:1PL.II
gitga'adiit_ga'a'm	ga'a'm	X;IN:ROOT;IN:PL;IN:3PL.II;OUT:ROOT;OUT:TR;OUT:1PL.II
dibekw_hlo'ot	dibekwt	X;IN:ROOT;IN:PL;OUT:ROOT;OUT:PL;OUT:3.II
huksi'y_siK'ap	huks	X;IN:ROOT;IN:1SG.II;OUT:ROOT
wendiit_wani'm	weni'm	X;IN:ROOT;IN:PL;IN:3PL.II;OUT:ROOT;OUT:PL;OUT:1PL.II
jisjahlit_yukw	jehl	X;IN:ROOT;IN:PL;IN:TR;IN:3.II;OUT:ROOT
bekwdiit_Gant	'witxwt	X;IN:ROOT;IN:PL;IN:3PL.II;OUT:ROOT;OUT:3.II
yuxwdiit_sityeewit	yuwit	X;IN:ROOT;IN:3PL.II;OUT:ROOT;OUT:TR;OUT:3.II
ga'a'm_t'isdiit	ga'adiit	X;IN:ROOT;IN:1PL.II;OUT:ROOT;OUT:3PL.II
hahle'lst_t'ilXo'odiit	hahle'lsdiit	X;IN:ROOT;IN:3.II;OUT:ROOT;OUT:3PL.II
am'ama_jaXjoGat	am'amit	X;IN:ROOT;IN:PL;IN:ATTR;OUT:ROOT;OUT:PL;OUT:SX
noX_yukwdiit	noXdiit	X;IN:ROOT;OUT:ROOT;OUT:3PL.II
sbaGaytGanGan_ksibaXin	sbaaytGan	X;IN:ROOT;IN:PL;OUT:ROOT
kw'esini'y_gupt	kw'asint	X;IN:ROOT;IN:TR;IN:1SG.II;OUT:ROOT;OUT:3.II
wet_tK'ahisyetst	huwat	X;IN:ROOT;IN:3.II;OUT:ROOT;OUT:PL;OUT:3.II
saks_daha'wit	daa'wihlt	X;IN:ROOT;IN:PL;OUT:ROOT;OUT:3.II
Galhuksindiit_Go'odiit	tK'alhuksindiit	X;IN:ROOT;IN:3PL.II;OUT:ROOT;OUT:3PL.II
baXt_gut'ihlxwi'y	baXa'y	X;IN:ROOT;IN:3.II;OUT:ROOT;OUT:1SG.II
joGot_'masi'y	joGo'y	X;IN:ROOT;IN:SX;OUT:ROOT;OUT:1SG.II
Xpts'exw_niiniks	Xbits'iixw	X;IN:ROOT;OUT:ROOT;OUT:PL
joGat_dohot	jaXjoGot	X;IN:ROOT;IN:SX;OUT:ROOT;OUT:PL;OUT:SX
t'ihlxum_K'aK	t'ihlxw	X;IN:ROOT;IN:ATTR;OUT:ROOT
Goli'm_xseeK	Gol	X;IN:ROOT;IN:PL;IN:1PL.II;OUT:ROOT;OUT:PL
heldim_dukhlinXt	heltt	X;IN:ROOT;IN:ATTR;OUT:ROOT;OUT:3.II
jaXjoGat_xsididaa'whlt	joKt	X;IN:ROOT;IN:PL;IN:SX;OUT:ROOT;OUT:3.II
Galts'ept_dit'aX	Galjipts'ep	X;IN:ROOT;IN:3.II;OUT:ROOT;OUT:PL
wilaayi'y_anhet	wilaaxt	X;IN:ROOT;IN:TR;IN:1SG.II;OUT:ROOT;OUT:3.II
seksdiit_jaXjoGat	saksit	X;IN:ROOT;IN:PL;IN:3PL.II;OUT:ROOT;OUT:PL;OUT:SX
sinhun_didelKt	sinhunt	X;IN:ROOT;OUT:ROOT;OUT:3.II
gigiinuxwdiit_gigiinuxwin	gigiinuxwin	X;IN:ROOT;IN:3PL.II;OUT:ROOT;OUT:2SG.II
guut_t'ehldiit	doKdiit	X;IN:ROOT;IN:3.II;OUT:ROOT;OUT:PL;OUT:3PL.II
ga'adiit_anbisxw	ga'a	X;IN:ROOT;IN:3PL.II;OUT:ROOT
weni'm_dexwdiit	wandiit	X;IN:ROOT;IN:PL;IN:1PL.II;OUT:ROOT;OUT:PL;OUT:3PL.II
luuhitxwGootdiit_laXyip	luuhitxwGoot	X;IN:ROOT;IN:3PL.II;OUT:ROOT
hahle'lsit_hahla'lsdi'y	hahla'lsdi'y	X;IN:ROOT;IN:SX;OUT:ROOT;OUT:1SG.II
Xsdaat_simaa'y	Xsdaa	X;IN:ROOT;IN:3.II;OUT:ROOT
hlguts'uusgi'y_Gan'malat	hlguts'uusxt	X;IN:ROOT;IN:1SG.II;OUT:ROOT;OUT:3.II
t'aa_hlo'ot	went	X;IN:ROOT;OUT:ROOT;OUT:PL;OUT:SX
'nu'wit_dibekwt	dexwt	X;IN:ROOT;IN:SX;OUT:ROOT;OUT:PL;OUT:3.II
giihli'y_hashetsdiit	laahldiit	X;IN:ROOT;IN:1SG.II;OUT:ROOT;OUT:PL;OUT:3PL.II
Galts'ebi'm_niye'e'y	Galts'ebi'y	X;IN:ROOT;IN:1PL.II;OUT:ROOT;OUT:1SG.II
GaGoott_nakst	Goott	X;IN:ROOT;IN:PL;IN:3.II;OUT:ROOT;OUT:3.II
wilpdiit_tXooK	huwilp	X;IN:ROOT;IN:3PL.II;OUT:ROOT;OUT:PL
guut_xseeK	doK	X;IN:ROOT;IN:3.II;OUT:ROOT;OUT:PL
'yens_amgiigum	'yensa	X;IN:ROOT;OUT:ROOT;OUT:ATTR
t'aam_tK'ahisyetst	went	X;IN:ROOT;IN:ATTR;OUT:ROOT;OUT:PL;OUT:3.II
K'amksiwaamXdiit_gipaykw	(K'amksiwaamX)	X;IN:ROOT;IN:3PL.II;OUT:ROOT
da'witxwit_hashejit	dibegwit	X;IN:ROOT;IN:TR;IN:3.II;OUT:ROOT;OUT:PL;OUT:TR;OUT:3.II
amit_loGa	ama	X;IN:ROOT;IN:SX;OUT:ROOT;OUT:ATTR
yee'm_ha'wi'y	yee'y	X;IN:ROOT;IN:1PL.II;OUT:ROOT;OUT:1SG.II
bekwt_laahl	bakw	X;IN:ROOT;IN:PL;IN:3.II;OUT:ROOT;OUT:PL
bekw_Goldiit	bekwdiit	X;IN:ROOT;IN:PL;OUT:ROOT;OUT:PL;OUT:3PL.II
ga'a_ga'a'm	ga'a'm	X;IN:ROOT;OUT:ROOT;OUT:TR;OUT:1PL.II
waatxwt_amhe	waatxw	X;IN:ROOT;IN:3.II;OUT:ROOT
huwelixim_XshaneeK	weli	X;IN:ROOT;IN:PL;IN:ATTR;OUT:ROOT
aliisxu'm_gipaykw	aliisxw	X;IN:ROOT;IN:PL;IN:1PL.II;OUT:ROOT;OUT:PL
gwelgwa_gyoo	gwalkw	X;IN:ROOT;IN:ATTR;OUT:ROOT
japt_jixjiksindiit	jipjepdiit	X;IN:ROOT;IN:3.II;OUT:ROOT;OUT:PL;OUT:3PL.II
we'y_maa'yi'm	wa'm	X;IN:ROOT;IN:1SG.II;OUT:ROOT;OUT:1PL.II
'wayit_maGoon	'wa	X;IN:ROOT;IN:TR;IN:3.II;OUT:ROOT
Gol_dukhlinX	baX	X;IN:ROOT;IN:PL;OUT:ROOT
sGa'wa_hlendindiit	sGa'wadiit	X;IN:ROOT;OUT:ROOT;OUT:3PL.II
sgett_luuhitxwGoot	sget	X;IN:ROOT;IN:3.II;OUT:ROOT
baGa'm_loK	baK	X;IN:ROOT;IN:TR;IN:1PL.II;OUT:ROOT
we'y_wilpdiit	wadiit	X;IN:ROOT;IN:1SG.II;OUT:ROOT;OUT:3PL.II
baKdiit_gi'nami'y	baGa'y	X;IN:ROOT;IN:3PL.II;OUT:ROOT;OUT:TR;OUT:1SG.II
limXs_nibibi'y	'mesi'y	X;IN:ROOT;IN:PL;OUT:ROOT;OUT:1SG.II
a'laXan_'mits'indiit	a'laXdiit	X;IN:ROOT;IN:2SG.II;OUT:ROOT;OUT:3PL.II
ky'ul_K'oo'ldit	ky'ult	X;IN:ROOT;OUT:ROOT;OUT:SX
loodiit_loot	loot	X;IN:ROOT;IN:PL;IN:3PL.II;OUT:ROOT;OUT:PL;OUT:3.II
bekwt_anjoKt	'witxwt	X;IN:ROOT;IN:PL;IN:3.II;OUT:ROOT;OUT:3.II
GedaXdiit_sins	gidaX	X;IN:ROOT;IN:3PL.II;OUT:ROOT
alisxw_dewdew	aliisxw	X;IN:ROOT;OUT:ROOT;OUT:PL
hloXsa_hooyin	hloXs	X;IN:ROOT;IN:ATTR;OUT:ROOT
wani'm_mismesxw	wen	X;IN:ROOT;IN:PL;IN:1PL.II;OUT:ROOT;OUT:PL
hediit_gi'namt	het	X;IN:ROOT;IN:3PL.II;OUT:ROOT;OUT:3.II
ha'wdiit_maa'yi'm	ha'u'm	X;IN:ROOT;IN:3PL.II;OUT:ROOT;OUT:1PL.II
gidaXt_men	gidaX	X;IN:ROOT;IN:3.II;OUT:ROOT
guut_hisyetst	doKt	X;IN:ROOT;IN:3.II;OUT:ROOT;OUT:PL;OUT:3.II
gipaykwt_aaKt	gipaykwt	X;IN:ROOT;IN:PL;IN:3.II;OUT:ROOT;OUT:3.II
sgit_saGaytwendiit	doXdiit	X;IN:ROOT;IN:3.II;OUT:ROOT;OUT:PL;OUT:3PL.II
hahle'lsdiit_k'uuhl;	hahle'lst	X;IN:ROOT;IN:3PL.II;OUT:ROOT
wat_'witxwit	wat	X;IN:ROOT;IN:3.II;OUT:ROOT;OUT:SX
hishalaagaXdiit_Gol	hishalaagaX	X;IN:ROOT;IN:PL;IN:3PL.II;OUT:ROOT;OUT:PL
jaXjoKt_doKdiit	jaXjoKdiit	X;IN:ROOT;IN:PL;IN:3.II;OUT:ROOT;OUT:PL;OUT:3PL.II
ga'a'm_gedi'y	ga'a'y	X;IN:ROOT;IN:1PL.II;OUT:ROOT;OUT:1SG.II
ha'wdiit_Xpts'ewi'y	ha'wi'y	X;IN:ROOT;IN:3PL.II;OUT:ROOT;OUT:1SG.II
hlo'o_wilplaahlt	hlo'ot	X;IN:ROOT;IN:PL;OUT:ROOT;OUT:PL;OUT:3.II
daha'wdiit_Goodat	daha'wt	X;IN:ROOT;IN:3PL.II;OUT:ROOT;OUT:3.II
Gabidiit_iwit	Gabit	X;IN:ROOT;IN:3PL.II;OUT:ROOT;OUT:SX
nekst_gwiiseeK	niiniks	X;IN:ROOT;IN:3.II;OUT:ROOT;OUT:PL
noho'y_Gayt	noX	X;IN:ROOT;IN:1SG.II;OUT:ROOT
dast_'nakw	das	X;IN:ROOT;IN:3.II;OUT:ROOT
'witxwt_am'amt	bekwt	X;IN:ROOT;IN:3.II;OUT:ROOT;OUT:PL;OUT:3.II
ga'a_a'laXa'm	ga'a'm	X;IN:ROOT;OUT:ROOT;OUT:1PL.II
hooyi'm_hlimoo'ldiit	hooxdiit	X;IN:ROOT;IN:TR;IN:1PL.II;OUT:ROOT;OUT:3PL.II
hasaK_smaxt	hasaKt	X;IN:ROOT;OUT:ROOT;OUT:3.II
dibekwt_Go'odiit	di'witxwdiit	X;IN:ROOT;IN:PL;IN:3.II;OUT:ROOT;OUT:3PL.II
ha'wi'y_didilsdiit	ha'wdiit	X;IN:ROOT;IN:1SG.II;OUT:ROOT;OUT:3PL.II
noXa'y_hasaGa'm	noXo'm	X;IN:ROOT;IN:1SG.II;OUT:ROOT;OUT:1PL.II
ts'uusxim_maGoon	ts'uus	X;IN:ROOT;IN:ATTR;OUT:ROOT
nigwootdiit_'wat	nigwoott	X;IN:ROOT;IN:3PL.II;OUT:ROOT;OUT:3.II
loGom_sim'oogitt	loKt	X;IN:ROOT;IN:ATTR;OUT:ROOT;OUT:3.II
saGaytGootda_swit	saGaytGoot	X;IN:ROOT;IN:3PL;OUT:ROOT
ga'a'y_'mits'indiit	ga'adiit	X;IN:ROOT;IN:TR;IN:1SG.II;OUT:ROOT;OUT:3PL.II
doXt_hlgi	doX	X;IN:ROOT;IN:PL;IN:3.II;OUT:ROOT;OUT:PL
laahli'm_laX'ut	giihlt	X;IN:ROOT;IN:PL;IN:1PL.II;OUT:ROOT;OUT:3.II
joKt_dexwdiit	jaXjoKdiit	X;IN:ROOT;IN:3.II;OUT:ROOT;OUT:PL;OUT:3PL.II
ha'u'm_t'is	ha'w	X;IN:ROOT;IN:1PL.II;OUT:ROOT
hahla'ljit_t'aat	hahle'lsit	X;IN:ROOT;IN:SX;OUT:ROOT;OUT:SX
want_'witxwit	t'aat	X;IN:ROOT;IN:PL;IN:3.II;OUT:ROOT;OUT:SX
Galts'ebi'm_laK	Galts'ap	X;IN:ROOT;IN:1PL.II;OUT:ROOT
ha'wi'm_wegi'y	ha'wi'y	X;IN:ROOT;IN:1PL.II;OUT:ROOT;OUT:1SG.II
'wayi'm_naX'niyit	'wayit	X;IN:ROOT;IN:TR;IN:1PL.II;OUT:ROOT;OUT:TR;OUT:3.II
wendiit_lixleyit	want	X;IN:ROOT;IN:PL;IN:3PL.II;OUT:ROOT;OUT:PL;OUT:SX
'nakw_tK'at	'nekwt	X;IN:ROOT;OUT:ROOT;OUT:3.II
'witxwi'y_mail	'witxw	X;IN:ROOT;IN:1SG.II;OUT:ROOT
lixsgat_ts'uusgim	lixsgadim	X;IN:ROOT;OUT:ROOT;OUT:ATTR
hasaKsi'm_gupt	hasaKt	X;IN:ROOT;IN:2PL.II;OUT:ROOT;OUT:3.II
'nu'wit_kwsdinsit	'nu'wt	X;IN:ROOT;IN:SX;OUT:ROOT;OUT:SX
went_mas'usi'm	weni'm	X;IN:ROOT;IN:PL;IN:SX;OUT:ROOT;OUT:PL;OUT:1PL.II
halaaxt_hlibuut	wilaaxt	X;IN:ROOT;IN:3.II;OUT:ROOT;OUT:3.II
seks_am'amit	saksit	X;IN:ROOT;IN:PL;OUT:ROOT;OUT:PL;OUT:SX
weli_loKt	welixt	X;IN:ROOT;OUT:ROOT;OUT:3.II
hlgit_limXsim	hlgim	X;IN:ROOT;IN:PL;IN:3.II;OUT:ROOT;OUT:PL;OUT:ATTR
jixjiksindiit_hilendiit	jiksindiit	X;IN:ROOT;IN:PL;IN:3PL.II;OUT:ROOT;OUT:3PL.II
gubi'y_gaks	gup	X;IN:ROOT;IN:TR;IN:1SG.II;OUT:ROOT
dibakw_suuhlo'odiit	di'witxwdiit	X;IN:ROOT;IN:PL;OUT:ROOT;OUT:3PL.II
jipjepdiit_ts'iibit	jabit	X;IN:ROOT;IN:PL;IN:3PL.II;OUT:ROOT;OUT:TR;OUT:3.II
saGaytGoot_baGadilda	saGaytGootda	X;IN:ROOT;OUT:ROOT;OUT:3PL
wiyitxw_wildigitxwdiit	wiyitxwdiit	X;IN:ROOT;OUT:ROOT;OUT:3PL.II
jaXjoGo'm_dexwit	jaXjoGot	X;IN:ROOT;IN:PL;IN:1PL.II;OUT:ROOT;OUT:PL;OUT:SX
lixleyit_k'eeKin	la	X;IN:ROOT;IN:PL;IN:SX;OUT:ROOT
aamit_laaGal	am	X;IN:ROOT;IN:SX;OUT:ROOT
xseeK_K'apt	xsaxwt	X;IN:ROOT;IN:PL;OUT:ROOT;OUT:3.II
jaXjoGat_laXyip	joK	X;IN:ROOT;IN:PL;IN:SX;OUT:ROOT
daXgedi'm_gi'namhlxum	daXgadim	X;IN:ROOT;IN:1PL.II;OUT:ROOT;OUT:ATTR
gwiiladiit_iksdet	gwilat	X;IN:ROOT;IN:PL;IN:3PL.II;OUT:ROOT;OUT:3.II
lukwdiit_haky'o'ot	lukwt	X;IN:ROOT;IN:3PL.II;OUT:ROOT;OUT:3.II
heltda_gilbilt	heldit	X;IN:ROOT;IN:3PL;OUT:ROOT;OUT:SX
mesxw_sbaGaytGanGan	mismesxw	X;IN:ROOT;OUT:ROOT;OUT:PL
noXo'm_isin	noXon	X;IN:ROOT;IN:1PL.II;OUT:ROOT;OUT:2SG.II
doKt_laXlaK	doK	X;IN:ROOT;IN:PL;IN:3.II;OUT:ROOT;OUT:PL
wilsi'm_saGaytGootda	wilda	X;IN:ROOT;IN:2PL.II;OUT:ROOT;OUT:3PL
wilaayit_ts'int	wilaaxt	X;IN:ROOT;IN:TR;IN:3.II;OUT:ROOT;OUT:3.II
yuxwit_gitxt	yuxwt	X;IN:ROOT;IN:TR;IN:3.II;OUT:ROOT;OUT:3.II
baGadili'm_t'ipXaadit	baGadilt	X;IN:ROOT;IN:1PL.II;OUT:ROOT;OUT:SX
liksgedim_gipaykw	lixsgat	X;IN:ROOT;IN:ATTR;OUT:ROOT
algaXdiit_Galts'ebi'm	algaXa'm	X;IN:ROOT;IN:3PL.II;OUT:ROOT;OUT:1PL.II
gitxsdiit_jaXjoGat	gigitxsit	X;IN:ROOT;IN:3PL.II;OUT:ROOT;OUT:PL;OUT:SX
gidiidoK_Gos	gidiiguu	X;IN:ROOT;IN:PL;OUT:ROOT
dohot_Goldiit	doXdiit	X;IN:ROOT;IN:PL;IN:SX;OUT:ROOT;OUT:PL;OUT:3PL.II
wilaayit_wilpdiit	halaaxdiit	X;IN:ROOT;IN:TR;IN:3.II;OUT:ROOT;OUT:3PL.II
gwilat_hlo'odiit	gwiiladiit	X;IN:ROOT;IN:3.II;OUT:ROOT;OUT:PL;OUT:3PL.II
dibekwt_doGot	dibegwit	X;IN:ROOT;IN:PL;IN:3.II;OUT:ROOT;OUT:PL;OUT:TR;OUT:3.II
ayukwsim_andep	ayukws	X;IN:ROOT;IN:ATTR;OUT:ROOT
Goodi'm_hen	Goodin	X;IN:ROOT;IN:1PL.II;OUT:ROOT;OUT:2SG.II
wen_dildilsit	want	X;IN:ROOT;IN:PL;OUT:ROOT;OUT:PL;OUT:SX
joGot_ky'ul	joK	X;IN:ROOT;IN:SX;OUT:ROOT
hahle'lsdi'm_gidaXa'm	hahla'lsdi'm	X;IN:ROOT;IN:1PL.II;OUT:ROOT;OUT:1PL.II
yeet_a'laXt	yeet	X;IN:ROOT;IN:SX;OUT:ROOT;OUT:3.II
'negwit_laXyipt	'nekwt	X;IN:ROOT;IN:SX;OUT:ROOT;OUT:3.II
joGot_gigeenixt	joKt	X;IN:ROOT;IN:SX;OUT:ROOT;OUT:3.II
dexw_Gooda	'nu'w	X;IN:ROOT;IN:PL;OUT:ROOT
ayawaatxw_xwdaxt	ayawaatxwt	X;IN:ROOT;OUT:ROOT;OUT:3.II
ayawaatxwt_ayukwsdiit	ayawaatxwdiit	X;IN:ROOT;IN:3.II;OUT:ROOT;OUT:3PL.II
jept_anjapt	japt	X;IN:ROOT;IN:3.II;OUT:ROOT;OUT:3.II
jiksin_GaGootdiit	jixjiksindiit	X;IN:ROOT;OUT:ROOT;OUT:PL;OUT:3PL.II
baXt_tK'alitt	Golt	X;IN:ROOT;IN:3.II;OUT:ROOT;OUT:PL;OUT:3.II
gigitxsit_hasaKdiit	gitxsdiit	X;IN:ROOT;IN:PL;IN:SX;OUT:ROOT;OUT:3PL.II
wili'm_sa'anlayt'ixdiit	wildiit	X;IN:ROOT;IN:1PL.II;OUT:ROOT;OUT:3PL.II
daa'wihlt_simaa'y	daa'whl	X;IN:ROOT;IN:3.II;OUT:ROOT
hlguts'uusgi'y_wili'm	hlguts'uusgi'm	X;IN:ROOT;IN:1SG.II;OUT:ROOT;OUT:1PL.II
yeet_kwsdins	yee	X;IN:ROOT;IN:3.II;OUT:ROOT
weni'm_dildilsit	wanit	X;IN:ROOT;IN:PL;IN:1PL.II;OUT:ROOT;OUT:PL;OUT:SX
Xa'nii'y_pdelt	Xa'nit	X;IN:ROOT;IN:TR;IN:1SG.II;OUT:ROOT;OUT:3.II
ky'ult_ts'ee	ky'ul	X;IN:ROOT;IN:SX;OUT:ROOT
'witxwt_woowaX	bekw	X;IN:ROOT;IN:3.II;OUT:ROOT;OUT:PL
liluxwsisi'm_woK'diit	liluxwsdiit	X;IN:ROOT;IN:2PL.II;OUT:ROOT;OUT:3PL.II
dibekwt_Golt	dibekwt	X;IN:ROOT;IN:PL;IN:3.II;OUT:ROOT;OUT:PL;OUT:3.II
yee_GaGoott	hlo'ot	X;IN:ROOT;OUT:ROOT;OUT:PL;OUT:3.II
sekst_laahldiit	seksdiit	X;IN:ROOT;IN:PL;IN:3.II;OUT:ROOT;OUT:PL;OUT:3PL.II
loo_luut'ehldiit	loodiit	X;IN:ROOT;IN:PL;OUT:ROOT;OUT:PL;OUT:3PL.II
saabekwt_hashetsdiit	saabekwdiit	X;IN:ROOT;IN:PL;IN:3.II;OUT:ROOT;OUT:PL;OUT:3PL.II
algaXa'y_t'aXt	algaXt	X;IN:ROOT;IN:1SG.II;OUT:ROOT;OUT:3.II
guu_huwat	doKt	X;IN:ROOT;OUT:ROOT;OUT:PL;OUT:3.II
get_joGo'y	gedi'y	X;IN:ROOT;OUT:ROOT;OUT:1SG.II
he_laXyibit	heet	X;IN:ROOT;OUT:ROOT;OUT:SX
noXt_hlguuhlxwi'y	noXa'y	X;IN:ROOT;IN:3.II;OUT:ROOT;OUT:1SG.II
jepdiit_wilaayisi'm	jebisi'm	X;IN:ROOT;IN:3PL.II;OUT:ROOT;OUT:TR;OUT:2PL.II
dexw_luut'ehldiit	dexwdiit	X;IN:ROOT;IN:PL;OUT:ROOT;OUT:PL;OUT:3PL.II
heldim_saGaytGootda	heltda	X;IN:ROOT;IN:ATTR;OUT:ROOT;OUT:3PL
'wiidaX_sa'apt'i	'wii	X;IN:ROOT;IN:PL;OUT:ROOT
saGaytGootda_hooxdiit	saGaytGootdiit	X;IN:ROOT;IN:3PL;OUT:ROOT;OUT:3PL.II
helt_lim'oo'yt	heltt	X;IN:ROOT;OUT:ROOT;OUT:3.II
baGa'm_sgit	baKt	X;IN:ROOT;IN:TR;IN:1PL.II;OUT:ROOT;OUT:3.II
dexwdiit_Xsdaadiit	'nu'wdiit	X;IN:ROOT;IN:PL;IN:3PL.II;OUT:ROOT;OUT:3PL.II
hooyit_baGa'm	hooyi'm	X;IN:ROOT;IN:TR;IN:3.II;OUT:ROOT;OUT:TR;OUT:1PL.II
went_t'aan	t'aan	X;IN:ROOT;IN:PL;IN:3.II;OUT:ROOT;OUT:2SG.II
sdil_he'm	sdili'm	X;IN:ROOT;OUT:ROOT;OUT:1PL.II
doK_dibegwit	doGot	X;IN:ROOT;IN:PL;OUT:ROOT;OUT:PL;OUT:TR;OUT:3.II
huwat_Xa'naayi'm	wa'm	X;IN:ROOT;IN:PL;IN:3.II;OUT:ROOT;OUT:1PL.II
t'aat_huudi'm	weni'm	X;IN:ROOT;IN:SX;OUT:ROOT;OUT:PL;OUT:1PL.II
simgigat_hishalaagaX	simgigat	X;IN:ROOT;IN:PL;OUT:ROOT;OUT:PL
niiniks_hogaGam	neksim	X;IN:ROOT;IN:PL;OUT:ROOT;OUT:ATTR
wil_moohli'm	wili'm	X;IN:ROOT;OUT:ROOT;OUT:1PL.II
hahla'lsdi'y_heet	hahle'lsit	X;IN:ROOT;IN:1SG.II;OUT:ROOT;OUT:SX
huwilaa_sgett	wilaaxt	X;IN:ROOT;IN:PL;OUT:ROOT;OUT:3.II
hishalaagaXdiit_wadiit	ts'ehlXdiit	X;IN:ROOT;IN:PL;IN:3PL.II;OUT:ROOT;OUT:3PL.II
wekt_naX'nit	wakt	X;IN:ROOT;IN:3.II;OUT:ROOT;OUT:3.II
gitga'adiit_wili'y	ga'a'y	X;IN:ROOT;IN:PL;IN:3PL.II;OUT:ROOT;OUT:1SG.II
baKt_baGa'y	baGa'y	X;IN:ROOT;IN:3.II;OUT:ROOT;OUT:TR;OUT:1SG.II
gupdiit_ayawaatxwt	gupt	X;IN:ROOT;IN:3PL.II;OUT:ROOT;OUT:3.II
hahla'lsdi'm_heet	hahle'lsit	X;IN:ROOT;IN:1PL.II;OUT:ROOT;OUT:SX
dils_laahldiit	dildilsdiit	X;IN:ROOT;OUT:ROOT;OUT:PL;OUT:3PL.II
tXalpXu'm_dekhl	tXalpX	X;IN:ROOT;IN:1PL.II;OUT:ROOT
desdiit_hlibuut	dast	X;IN:ROOT;IN:3PL.II;OUT:ROOT;OUT:3.II
dibekwt_tXooK	dibekw	X;IN:ROOT;IN:PL;IN:3.II;OUT:ROOT;OUT:PL
wili'y_K'amksiwaamXdiit	wildiit	X;IN:ROOT;IN:1SG.II;OUT:ROOT;OUT:3PL.II
jebisi'm_ha'wdiit	japdiit	X;IN:ROOT;IN:TR;IN:2PL.II;OUT:ROOT;OUT:3PL.II
sGa'wa_hlguts'uusxt	sGa'wat	X;IN:ROOT;OUT:ROOT;OUT:3.II
amet_jiip	amhe	X;IN:ROOT;IN:3.II;OUT:ROOT
wan_tXalpXat	t'aat	X;IN:ROOT;IN:PL;OUT:ROOT;OUT:SX
t'ist_Xpts'exw	t'is	X;IN:ROOT;IN:3.II;OUT:ROOT
saGaytGoot_luuhitxwGootdiit	saGaytGootdiit	X;IN:ROOT;OUT:ROOT;OUT:3PL.II
sise'ediit_office	se'e	X;IN:ROOT;IN:PL;IN:3PL.II;OUT:ROOT
wilaaxt_yuwi'y	wilaayi'y	X;IN:ROOT;IN:3.II;OUT:ROOT;OUT:TR;OUT:1SG.II
guts'uusgi'y_noho'y	hlguts'uusgi'y	X;IN:ROOT;IN:1SG.II;OUT:ROOT;OUT:1SG.II
wil'naat'ahldiit_Galts'ept	wil'naat'ahlt	X;IN:ROOT;IN:3PL.II;OUT:ROOT;OUT:3.II
xsawi'y_gaks	xsaxw	X;IN:ROOT;IN:1SG.II;OUT:ROOT
baXyuxw_waatxwdiit	baXyuxwdiithl	X;IN:ROOT;OUT:ROOT;OUT:3PL.II
simgigat_woowaX	simgiget	X;IN:ROOT;IN:PL;OUT:ROOT;OUT:PL
Goodain_laahldiit	GatGoodindiit	X;IN:ROOT;OUT:ROOT;OUT:PL;OUT:3PL.II
mesxw_wat	masxwt	X;IN:ROOT;OUT:ROOT;OUT:3.II
naX'ni_ha'widint	Xa'nit	X;IN:ROOT;OUT:ROOT;OUT:3.II
gidaXt_hooyit	gidaXat	X;IN:ROOT;IN:3.II;OUT:ROOT;OUT:TR;OUT:3.II
joKt_dexwit	jaXjoGot	X;IN:ROOT;IN:3.II;OUT:ROOT;OUT:PL;OUT:SX
wan_jaXjoGo'm	weni'm	X;IN:ROOT;IN:PL;OUT:ROOT;OUT:PL;OUT:1PL.II
niye'e'y_anooK	niye'e	X;IN:ROOT;IN:1SG.II;OUT:ROOT
baGa'y_'wayi'm	baGa'm	X;IN:ROOT;IN:TR;IN:1SG.II;OUT:ROOT;OUT:TR;OUT:1PL.II
'waat'aX_mukw	'wii	X;IN:ROOT;IN:PL;OUT:ROOT
hlguuhlxum_ii'wxwt	hlgi	X;IN:ROOT;IN:ATTR;OUT:ROOT;OUT:PL
bekwt_ts'eext	'witxwt	X;IN:ROOT;IN:PL;IN:3.II;OUT:ROOT;OUT:3.II
'wayit_Getxwt	'wat	X;IN:ROOT;IN:TR;IN:3.II;OUT:ROOT;OUT:3.II
want_ama	t'aam	X;IN:ROOT;IN:PL;IN:SX;OUT:ROOT;OUT:ATTR
jehlit_hashejit	jisjahlit	X;IN:ROOT;IN:TR;IN:3.II;OUT:ROOT;OUT:PL;OUT:TR;OUT:3.II
maKt_bekw	t'ehl	X;IN:ROOT;IN:3.II;OUT:ROOT;OUT:PL
gi'namt_hanaK'	gi'nam	X;IN:ROOT;IN:3.II;OUT:ROOT
masxwit_gwelkwt	masxwt	X;IN:ROOT;IN:SX;OUT:ROOT;OUT:3.II
ga'adiit_isi'm	ga'a'm	X;IN:ROOT;IN:3PL.II;OUT:ROOT;OUT:1PL.II
wilsi'm_iwit	wilt	X;IN:ROOT;IN:2PL.II;OUT:ROOT;OUT:SX
laXyibi'm_gwila	laXyip	X;IN:ROOT;IN:1PL.II;OUT:ROOT
saahlo'odiit_hashetsdiit	saahlo'odiit	X;IN:ROOT;IN:PL;IN:3PL.II;OUT:ROOT;OUT:PL;OUT:3PL.II
niinixs_do'ot	nakst	X;IN:ROOT;IN:PL;OUT:ROOT;OUT:3.II
t'aan_t'isit	t'aat	X;IN:ROOT;IN:2SG.II;OUT:ROOT;OUT:SX
Gabidiit_amet	Gabiit	X;IN:ROOT;IN:3PL.II;OUT:ROOT;OUT:3.II
loKt_hlgut'ihlxw	loK	X;IN:ROOT;IN:3.II;OUT:ROOT
am'ama_ehldit'aa	am	X;IN:ROOT;IN:PL;IN:ATTR;OUT:ROOT
halaaxdiit_sgit	wilaaxt	X;IN:ROOT;IN:3PL.II;OUT:ROOT;OUT:3.II
want_aliisxu'm	wani'm	X;IN:ROOT;IN:PL;IN:3.II;OUT:ROOT;OUT:PL;OUT:1PL.II
wiyitxwdiit_wildiit	wiyitsxwdiit	X;IN:ROOT;IN:3PL.II;OUT:ROOT;OUT:3PL.II
alisxu'm_ts'ak'	alisxw	X;IN:ROOT;IN:1PL.II;OUT:ROOT
luxdaxdiit_baGadili'm	Xdeyi'm	X;IN:PL;IN:ROOT;IN:3PL.II;OUT:ROOT;OUT:1PL.II
he_baasxdiit	hediit	X;IN:ROOT;OUT:ROOT;OUT:3PL.II
guxwt_didalGan	guxwin	X;IN:ROOT;IN:3.II;OUT:ROOT;OUT:TR;OUT:2SG.II
t'aat_daXgadim	t'aam	X;IN:ROOT;IN:3.II;OUT:ROOT;OUT:ATTR
wilt_Go'osi'm	wisi'm	X;IN:ROOT;IN:SX;OUT:ROOT;OUT:2PL.II
gup_adaawKt	gupt	X;IN:ROOT;OUT:ROOT;OUT:3.II
lukw_baXyuxwdiithl	lukwdiit	X;IN:ROOT;OUT:ROOT;OUT:3PL.II
wandiit_yukwsin	t'aa	X;IN:ROOT;IN:PL;IN:3PL.II;OUT:ROOT
noXt_K'ay'mesi'y	noho'y	X;IN:ROOT;IN:3.II;OUT:ROOT;OUT:1SG.II
wani'm_gigitxsit	wanit	X;IN:ROOT;IN:PL;IN:1PL.II;OUT:ROOT;OUT:PL;OUT:SX
baGadilim_gem	baGadil	X;IN:ROOT;IN:ATTR;OUT:ROOT
da'aKhlxwin_tXo'odiit	da'aKhlxwdiit	X;IN:ROOT;IN:2SG.II;OUT:ROOT;OUT:3PL.II
'mas_gemgim	'mesim	X;IN:ROOT;OUT:ROOT;OUT:ATTR
saksdiit_guk'uuhl	seks	X;IN:ROOT;IN:PL;IN:3PL.II;OUT:ROOT;OUT:PL
hlimoo_alisxu'm	hlimoo'm	X;IN:ROOT;OUT:ROOT;OUT:1PL.II
laXyibit_luusgi	laXyip	X;IN:ROOT;IN:SX;OUT:ROOT
hahla'ljit_gut'ihlxwi'y	hahla'lsdi'y	X;IN:ROOT;IN:SX;OUT:ROOT;OUT:1SG.II
gidaXa'm_ga'adiit	GedaXdiit	X;IN:ROOT;IN:1PL.II;OUT:ROOT;OUT:3PL.II
daa'wihlt_dildilsit	seksit	X;IN:ROOT;IN:3.II;OUT:ROOT;OUT:PL;OUT:SX
ts'ebim_meeXt	ts'ept	X;IN:ROOT;IN:ATTR;OUT:ROOT;OUT:3.II
ts'ept_joKdiit	ts'epdiit	X;IN:ROOT;IN:3.II;OUT:ROOT;OUT:3PL.II
yuwi'y_amkst	yuxwt	X;IN:ROOT;IN:TR;IN:1SG.II;OUT:ROOT;OUT:3.II
nigwoodi'm_gi'namt	nigwoott	X;IN:ROOT;IN:1PL.II;OUT:ROOT;OUT:3.II
laXyip_hahla'lsdi'm	laXyibi'm	X;IN:ROOT;OUT:ROOT;OUT:1PL.II
jiksindiit_t'ehldiit	jixjiksindiit	X;IN:ROOT;IN:3PL.II;OUT:ROOT;OUT:PL;OUT:3PL.II
seksit_wat	daa'whlit	X;IN:ROOT;IN:PL;IN:SX;OUT:ROOT;OUT:SX
gidaXat_gwiladiit	gidaXdiit	X;IN:ROOT;IN:TR;IN:3.II;OUT:ROOT;OUT:3PL.II
yee'y_gwila'm	yee'm	X;IN:ROOT;IN:1SG.II;OUT:ROOT;OUT:1PL.II
waatxwit_asdint	waatxwt	X;IN:ROOT;IN:SX;OUT:ROOT;OUT:3.II
bitxum_'witxwit	bitxwit	X;IN:ROOT;IN:ATTR;OUT:ROOT;OUT:SX
het_hahla'lsdi'y	he'y	X;IN:ROOT;IN:3.II;OUT:ROOT;OUT:1SG.II
gimxdiidiit_lekw	gimxdi	X;IN:ROOT;IN:3PL.II;OUT:ROOT
wa'm_haky'o'ot	wat	X;IN:ROOT;IN:1PL.II;OUT:ROOT;OUT:3.II
ts'uusgim_Galts'ebi'y	ts'uusgi'y	X;IN:ROOT;IN:ATTR;OUT:ROOT;OUT:1SG.II
wilpdiit_hlo'ot	huwilpt	X;IN:ROOT;IN:3PL.II;OUT:ROOT;OUT:PL;OUT:3.II
wilt_gi'namt	wilt	X;IN:ROOT;IN:SX;OUT:ROOT;OUT:3.II
seksit_ha'niiwilXsdiit	saksdiit	X;IN:ROOT;IN:PL;IN:SX;OUT:ROOT;OUT:PL;OUT:3PL.II
hlimoodiit_baGadili'm	hlimoo'm	X;IN:ROOT;IN:3PL.II;OUT:ROOT;OUT:1PL.II
K'ay'mesi'y_anhahla'lsdi'y	K'ay'mesi'y	X;IN:ROOT;IN:1SG.II;OUT:ROOT;OUT:1SG.II
gidaXdiit_ayukws	gidaX	X;IN:ROOT;IN:3PL.II;OUT:ROOT
t'ehl_naX'ni	maK	X;IN:ROOT;IN:PL;OUT:ROOT
anooKt_ayukwsi'm	anooGo'm	X;IN:ROOT;IN:3.II;OUT:ROOT;OUT:1PL.II
mihas'usin_hlgi	mihas'us	X;IN:ROOT;IN:PL;IN:2SG.II;OUT:ROOT;OUT:PL
ga'at_amt	ga'at	X;IN:ROOT;IN:3.II;OUT:ROOT;OUT:3.II
'nu'wt_gigitxsit	dexwit	X;IN:ROOT;IN:SX;OUT:ROOT;OUT:PL;OUT:SX
mas'usi'm_noho'y	ma'usi'y	X;IN:ROOT;IN:PL;IN:1PL.II;OUT:ROOT;OUT:1SG.II
bekwt_dibekwt	bekwt	X;IN:ROOT;IN:PL;IN:3.II;OUT:ROOT;OUT:PL;OUT:3.II
wanit_hlo'o'm	wani'm	X;IN:ROOT;IN:PL;IN:SX;OUT:ROOT;OUT:PL;OUT:1PL.II
halaaxt_'mootxwit	wilaayit	X;IN:ROOT;IN:3.II;OUT:ROOT;OUT:TR;OUT:3.II
Gost_baXyuxw	Gos	X;IN:ROOT;IN:3.II;OUT:ROOT
hahla'lsdi'y_hlimoo'ltt	hahle'lst	X;IN:ROOT;IN:1SG.II;OUT:ROOT;OUT:3.II
wilaakwdiit_laXyipdiit	halaakwdiit	X;IN:ROOT;IN:3PL.II;OUT:ROOT;OUT:3PL.II
wandiit_huwilpt	went	X;IN:ROOT;IN:PL;IN:3PL.II;OUT:ROOT;OUT:PL;OUT:3.II
daa'whlt_yukw	daa'whl	X;IN:ROOT;IN:3.II;OUT:ROOT
yee_sbaGaytGanGan	hlo'o	X;IN:ROOT;OUT:ROOT;OUT:PL
Goodi'y_ha'niijoK	Goot	X;IN:ROOT;IN:1SG.II;OUT:ROOT
diyeediit_tK'alyeet	diyeet	X;IN:ROOT;IN:3PL.II;OUT:ROOT;OUT:3.II
giihlt_mas'usi'm	laahli'm	X;IN:ROOT;IN:3.II;OUT:ROOT;OUT:PL;OUT:1PL.II
ayooKt_anma'usdiit	ayooKdiit	X;IN:ROOT;IN:3.II;OUT:ROOT;OUT:3PL.II
sityeexw_midindiit	sityeexwdiit	X;IN:ROOT;OUT:ROOT;OUT:3PL.II
jaXjoKt_Gooda	joK	X;IN:ROOT;IN:PL;IN:3.II;OUT:ROOT
doKdiit_hashejit	doGot	X;IN:ROOT;IN:PL;IN:3PL.II;OUT:ROOT;OUT:PL;OUT:TR;OUT:3.II
dexwdiit_joGat	'nu'wt	X;IN:ROOT;IN:PL;IN:3PL.II;OUT:ROOT;OUT:SX
ts'ebim_maGoon	ts'ep	X;IN:ROOT;IN:ATTR;OUT:ROOT
gat_daXgadim	gedim	X;IN:ROOT;OUT:ROOT;OUT:ATTR
sgi_huwat	doXt	X;IN:ROOT;OUT:ROOT;OUT:PL;OUT:3.II
wilaayi'y_liseexwdiit	wilaaxdiit	X;IN:ROOT;IN:TR;IN:1SG.II;OUT:ROOT;OUT:3PL.II
ha'wi'y_hligu'm	ha'u'm	X;IN:ROOT;IN:1SG.II;OUT:ROOT;OUT:1PL.II
daa'wihlt_luuwendiit	saksdiit	X;IN:ROOT;IN:3.II;OUT:ROOT;OUT:PL;OUT:3PL.II
algaXdiit_ayawaatxw	algaX	X;IN:ROOT;IN:3PL.II;OUT:ROOT
begu'm_'yenst	'witxwt	X;IN:ROOT;IN:PL;IN:1PL.II;OUT:ROOT;OUT:3.II
'wiiyitxwt_sba'aKhlxwt	wiyitxwt	X;IN:ROOT;IN:3.II;OUT:ROOT;OUT:3.II
waatxw_XshaneeKt	waatxwt	X;IN:ROOT;OUT:ROOT;OUT:3.II
ga'a'y_baGa'm	ga'a'm	X;IN:ROOT;IN:TR;IN:1SG.II;OUT:ROOT;OUT:TR;OUT:1PL.II
want_lixleyit	went	X;IN:ROOT;IN:PL;IN:3.II;OUT:ROOT;OUT:PL;OUT:SX
huwilpt_wilt	wilpt	X;IN:ROOT;IN:PL;IN:3.II;OUT:ROOT;OUT:3.II
wendiit_loo	wen	X;IN:ROOT;IN:PL;IN:3PL.II;OUT:ROOT;OUT:PL
wili'y_hasaKsi'm	wisi'm	X;IN:ROOT;IN:1SG.II;OUT:ROOT;OUT:2PL.II
sdil_guseeKt	sdilt	X;IN:ROOT;OUT:ROOT;OUT:3.II
'maXs_Xsdaat	'maXst	X;IN:ROOT;OUT:ROOT;OUT:3.II
'wayi'm_andep	'wa	X;IN:ROOT;IN:TR;IN:1PL.II;OUT:ROOT
doK_sekst	doKt	X;IN:ROOT;IN:PL;OUT:ROOT;OUT:PL;OUT:3.II
ayukwst_guslisdiit	ayukwsdiit	X;IN:ROOT;IN:3.II;OUT:ROOT;OUT:3PL.II
t'isit_Xmaa'y	t'is	X;IN:ROOT;IN:SX;OUT:ROOT
gipaykwt_maasa	gipaygum	X;IN:ROOT;IN:PL;IN:3.II;OUT:ROOT;OUT:ATTR
gi'nami'y_algaXdiit	gi'namdiit	X;IN:ROOT;IN:TR;IN:1SG.II;OUT:ROOT;OUT:3PL.II
yeet_hap	hlo'o	X;IN:ROOT;IN:3.II;OUT:ROOT;OUT:PL
anhee'y_a'laXt	anhet	X;IN:ROOT;IN:1SG.II;OUT:ROOT;OUT:3.II
K'otsdiit_la	K'ots	X;IN:ROOT;IN:3PL.II;OUT:ROOT
hlguuhlxwi'y_hlgi'y	hlgi'y	X;IN:ROOT;IN:1SG.II;OUT:ROOT;OUT:PL;OUT:1SG.II
GasGoot_iksde	GasGoo	X;IN:ROOT;IN:SX;OUT:ROOT
doGot_Galjipts'ep	doK	X;IN:ROOT;IN:PL;IN:TR;IN:3.II;OUT:ROOT;OUT:PL
hasaGa'm_gi'namdiit	hasaKdiit	X;IN:ROOT;IN:1PL.II;OUT:ROOT;OUT:3PL.II
jebin_ga'at	jabit	X;IN:ROOT;IN:TR;IN:2SG.II;OUT:ROOT;OUT:TR;OUT:3.II
algaX_hahla'lsdi'm	algaXa'm	X;IN:ROOT;OUT:ROOT;OUT:1PL.II
hooxt_gubi'm	hooyi'm	X;IN:ROOT;IN:3.II;OUT:ROOT;OUT:TR;OUT:1PL.II
hanaK'_gakst	hanaK't	X;IN:ROOT;OUT:ROOT;OUT:3.II
hashejit_Goodi'm	hiji'm	X;IN:ROOT;IN:PL;IN:TR;IN:3.II;OUT:ROOT;OUT:1PL.II
hilen_K'otsdiit	iilendiit	X;IN:ROOT;OUT:ROOT;OUT:3PL.II
noho'y_daXgett	noXt	X;IN:ROOT;IN:1SG.II;OUT:ROOT;OUT:3.II
daa'whl_woK't	daa'wihlt	X;IN:ROOT;OUT:ROOT;OUT:3.II
jaXjoGo'm_dexwit	jaXjoGat	X;IN:ROOT;IN:PL;IN:1PL.II;OUT:ROOT;OUT:PL;OUT:SX
huwilp_hlendindiit	wilpdiit	X;IN:ROOT;IN:PL;OUT:ROOT;OUT:3PL.II
wisi'm_'nii'wadiit	wildiit	X;IN:ROOT;IN:2PL.II;OUT:ROOT;OUT:3PL.II
wen_jaXjoGat	went	X;IN:ROOT;IN:PL;OUT:ROOT;OUT:PL;OUT:SX
ga'at_jixjiksindiit	gitga'adiit	X;IN:ROOT;IN:3.II;OUT:ROOT;OUT:PL;OUT:3PL.II
GaGootdiit_hlgit	GaGoott	X;IN:ROOT;IN:PL;IN:3PL.II;OUT:ROOT;OUT:PL;OUT:3.II
guxwin_'wa	guxw	X;IN:ROOT;IN:TR;IN:2SG.II;OUT:ROOT
saGaytGoot_saGaytGootda	saGaytGootda	X;IN:ROOT;OUT:ROOT;OUT:3PL
ha'wi'y_gyookst	ha'wt	X;IN:ROOT;IN:1SG.II;OUT:ROOT;OUT:3.II
nigwootdiit_aksi'm	nigwoodi'm	X;IN:ROOT;IN:3PL.II;OUT:ROOT;OUT:1PL.II
liluxws_amkst	liluxwst	X;IN:ROOT;OUT:ROOT;OUT:3.II
japdiit_hooyi'y	jebi'y	X;IN:ROOT;IN:3PL.II;OUT:ROOT;OUT:TR;OUT:1SG.II
seksdiit_aaKt	daa'whlt	X;IN:ROOT;IN:PL;IN:3PL.II;OUT:ROOT;OUT:3.II
japt_sgi	jep	X;IN:ROOT;IN:3.II;OUT:ROOT
wilda_luujoGat	wilt	X;IN:ROOT;IN:3PL;OUT:ROOT;OUT:SX
daa'whlit_doK	seks	X;IN:ROOT;IN:SX;OUT:ROOT;OUT:PL
'wayi'm_ga'adiit	'wadiit	X;IN:ROOT;IN:TR;IN:1PL.II;OUT:ROOT;OUT:3PL.II
Goot_noXdiit	Gootdiit	X;IN:ROOT;OUT:ROOT;OUT:3PL.II
noX_Ganaa'wt	noXt	X;IN:ROOT;OUT:ROOT;OUT:3.II
Galts'ebi'y_hlimoo'm	Galts'ebi'm	X;IN:ROOT;IN:1SG.II;OUT:ROOT;OUT:1PL.II
jept_wilaayisi'm	jebisi'm	X;IN:ROOT;IN:3.II;OUT:ROOT;OUT:TR;OUT:2PL.II
wanit_hlo'odiit	wandiit	X;IN:ROOT;IN:PL;IN:SX;OUT:ROOT;OUT:PL;OUT:3PL.II
doGo'm_saksdiit	doKdiit	X;IN:ROOT;IN:PL;IN:TR;IN:1PL.II;OUT:ROOT;OUT:PL;OUT:3PL.II
dibekw_guseeGat	da'witxwit	X;IN:ROOT;IN:PL;OUT:ROOT;OUT:TR;OUT:3.II
ksi'wadiit_nee	ksi'wa	X;IN:ROOT;IN:3PL.II;OUT:ROOT
dibakwdiit_simihldiit	di'witxwdiit	X;IN:ROOT;IN:PL;IN:3PL.II;OUT:ROOT;OUT:3PL.II
yee_ayawaatxwt	yeet	X;IN:ROOT;OUT:ROOT;OUT:3.II
want_noXon	t'aan	X;IN:ROOT;IN:PL;IN:3.II;OUT:ROOT;OUT:2SG.II
hasaGa'm_t'ilXoo'y	hasaGa'y	X;IN:ROOT;IN:1PL.II;OUT:ROOT;OUT:1SG.II
t'aat_hlo'o'm	wani'm	X;IN:ROOT;IN:SX;OUT:ROOT;OUT:PL;OUT:1PL.II
jaXjoGat_tXalpXu'm	joGo'm	X;IN:ROOT;IN:PL;IN:SX;OUT:ROOT;OUT:1PL.II
saksdiit_gidiidoK	saks	X;IN:ROOT;IN:PL;IN:3PL.II;OUT:ROOT;OUT:PL
Galts'epdiit_Galjipts'ep	Galjipts'ep	X;IN:ROOT;IN:3PL.II;OUT:ROOT;OUT:PL
jept_xsididaa'whl	jep	X;IN:ROOT;IN:3.II;OUT:ROOT
gi'y_gwilat	gi'yt	X;IN:ROOT;OUT:ROOT;OUT:3.II
hahla'lsdi'y_Galhuksindiit	hahle'lstdiit	X;IN:ROOT;IN:1SG.II;OUT:ROOT;OUT:3PL.II
wan_anbisxwit	t'aat	X;IN:ROOT;IN:PL;OUT:ROOT;OUT:SX
sgit_liksgetin	sgi	X;IN:ROOT;IN:3.II;OUT:ROOT
hlo'odiit_bekw	hlo'o	X;IN:ROOT;IN:PL;IN:3PL.II;OUT:ROOT;OUT:PL
guu_doGot	doGot	X;IN:ROOT;OUT:ROOT;OUT:PL;OUT:TR;OUT:3.II
wekt_guts'uusgi'y	wegi'y	X;IN:ROOT;IN:3.II;OUT:ROOT;OUT:1SG.II
guut_hithit't	doKt	X;IN:ROOT;IN:3.II;OUT:ROOT;OUT:PL;OUT:3.II
Galts'ept_nigwoodi'y	Galts'ebi'y	X;IN:ROOT;IN:3.II;OUT:ROOT;OUT:1SG.II
wiyitxwdiit_alisxw	wiyitxw	X;IN:ROOT;IN:3PL.II;OUT:ROOT
wil'naat'ehl_sinhunt	wil'naat'ehlt	X;IN:ROOT;OUT:ROOT;OUT:3.II
jaXjoKt_aX'algaGa'y	joGo'y	X;IN:ROOT;IN:PL;IN:3.II;OUT:ROOT;OUT:1SG.II
sekst_dit'aX	saks	X;IN:ROOT;IN:PL;IN:3.II;OUT:ROOT;OUT:PL
t'aX_maasa	t'aham	X;IN:ROOT;OUT:ROOT;OUT:ATTR
gi'namdiit_baXyuxw	gi'nam	X;IN:ROOT;IN:3PL.II;OUT:ROOT
guts'uusgi'm_nooGa'y	hlguts'uusgi'y	X;IN:ROOT;IN:1PL.II;OUT:ROOT;OUT:1SG.II
Golt_ansgit	baXt	X;IN:ROOT;IN:PL;IN:3.II;OUT:ROOT;OUT:3.II
ha'w_k'eeGani'm	ha'u'm	X;IN:ROOT;OUT:ROOT;OUT:1PL.II
k'eeGani'm_al'alGaldiit	huudindiit	X;IN:ROOT;IN:1PL.II;OUT:ROOT;OUT:PL;OUT:3PL.II
dexwit_al'alGalt	dexwt	X;IN:ROOT;IN:PL;IN:SX;OUT:ROOT;OUT:PL;OUT:3.II
yooK_jehlit	gubit	X;IN:ROOT;OUT:ROOT;OUT:TR;OUT:3.II
joGot_hlgit	jaXjoKt	X;IN:ROOT;IN:SX;OUT:ROOT;OUT:PL;OUT:3.II
wet_luuhitxwGoot	we	X;IN:ROOT;IN:3.II;OUT:ROOT
heldim_hogaGam	helda	X;IN:ROOT;IN:ATTR;OUT:ROOT;OUT:ATTR
huwat_dukhlinXt	wet	X;IN:ROOT;IN:PL;IN:3.II;OUT:ROOT;OUT:3.II
heldit_saGaytGoodindiit	heltdiit	X;IN:ROOT;IN:SX;OUT:ROOT;OUT:3PL.II
doX_etxwdiit	sgidiit	X;IN:ROOT;IN:PL;OUT:ROOT;OUT:3PL.II
gipaykw_aluut'aat	gipaykwt	X;IN:ROOT;IN:PL;OUT:ROOT;OUT:3.II
wani'm_hahlo'ot	want	X;IN:ROOT;IN:PL;IN:1PL.II;OUT:ROOT;OUT:PL;OUT:3.II
joK_ayukwsi'm	joGo'm	X;IN:ROOT;OUT:ROOT;OUT:1PL.II
wat_ts'u'wint	wat	X;IN:ROOT;IN:SX;OUT:ROOT;OUT:3.II
sgidiit_algaXt	sgit	X;IN:ROOT;IN:3PL.II;OUT:ROOT;OUT:3.II
hlguuhlxwi'yaa_baXa'y	hlguuhlxwi'y	X;IN:ROOT;IN:1SG.II;OUT:ROOT;OUT:1SG.II
ixwt_heldit	iwit	X;IN:ROOT;IN:3.II;OUT:ROOT;OUT:SX
laXyibit_daha'wdiit	laXyipdiit	X;IN:ROOT;IN:SX;OUT:ROOT;OUT:3PL.II
hahle'lsit_hlist	hahle'lst	X;IN:ROOT;IN:SX;OUT:ROOT;OUT:3.II
wildigitxw_sinhunt	wildigitxwit	X;IN:ROOT;OUT:ROOT;OUT:SX
wani'm_hogaGam	t'aam	X;IN:ROOT;IN:PL;IN:1PL.II;OUT:ROOT;OUT:ATTR
ha'wit_Goodi'm	ha'u'm	X;IN:ROOT;IN:3.II;OUT:ROOT;OUT:1PL.II
nigwoodi'm_sa'anlayt'ixdiit	nigwootdiit	X;IN:ROOT;IN:1PL.II;OUT:ROOT;OUT:3PL.II
wilt_heltda	wilda	X;IN:ROOT;IN:SX;OUT:ROOT;OUT:3PL
want_hap	wen	X;IN:ROOT;IN:PL;IN:3.II;OUT:ROOT;OUT:PL
wilaaxt_jiksindiit	halaaxdiit	X;IN:ROOT;IN:3.II;OUT:ROOT;OUT:3PL.II
want_anwilt	t'aat	X;IN:ROOT;IN:PL;IN:SX;OUT:ROOT;OUT:3.II
silget_hlo'odiit	silgetdiit	X;IN:ROOT;OUT:ROOT;OUT:3PL.II
t'amdiit_didalGan	t'amin	X;IN:ROOT;IN:3PL.II;OUT:ROOT;OUT:TR;OUT:2SG.II
waatxwdiit_aamit	waatxwit	X;IN:ROOT;IN:3PL.II;OUT:ROOT;OUT:SX
wili'm_wilsi'm	wilsi'm	X;IN:ROOT;IN:1PL.II;OUT:ROOT;OUT:2PL.II
loK_andabim	loGom	X;IN:ROOT;OUT:ROOT;OUT:ATTR
huwilp_luuwent	huwilpt	X;IN:ROOT;IN:PL;OUT:ROOT;OUT:PL;OUT:3.II
ky'ul_sa'anjapdiit	ky'uldiit	X;IN:ROOT;OUT:ROOT;OUT:3PL.II
wilda_a'laXan	win	X;IN:ROOT;IN:3PL;OUT:ROOT;OUT:2SG.II
liluxwsdiit_haxwdekwt	liluxwst	X;IN:ROOT;IN:3PL.II;OUT:ROOT;OUT:3.II
laXyipt_luuhitxwGootdiit	laXyipdiit	X;IN:ROOT;IN:3.II;OUT:ROOT;OUT:3PL.II
joK_GasGoot	joGat	X;IN:ROOT;OUT:ROOT;OUT:SX
didalK_'mits'indiit	didelKdiit	X;IN:ROOT;OUT:ROOT;OUT:3PL.II
jaXjoGo'm_ubint	joKt	X;IN:ROOT;IN:PL;IN:1PL.II;OUT:ROOT;OUT:3.II
wilaaxdiit_siwadit	wilaayit	X;IN:ROOT;IN:3PL.II;OUT:ROOT;OUT:TR;OUT:3.II
loot_saksdiit	loodiit	X;IN:ROOT;IN:PL;IN:3.II;OUT:ROOT;OUT:PL;OUT:3PL.II
wilaaxt_hlgi	huwilaa	X;IN:ROOT;IN:3.II;OUT:ROOT;OUT:PL
dibekw_sget	dikw'itxw	X;IN:ROOT;IN:PL;OUT:ROOT
ksi'wadiit_hoo	ksi'wa	X;IN:ROOT;IN:3PL.II;OUT:ROOT
want_hlgi	wan	X;IN:ROOT;IN:PL;IN:SX;OUT:ROOT;OUT:PL
'nu'wt_di'witxwdiit	'nu'wdiit	X;IN:ROOT;IN:3.II;OUT:ROOT;OUT:3PL.II
aluut'aat_'yenst	aluut'aat	X;IN:ROOT;IN:3.II;OUT:ROOT;OUT:3.II
ky'ult_baGadil	ky'ul	X;IN:ROOT;IN:3.II;OUT:ROOT
jebisi'm_Xbaa'wt	jept	X;IN:ROOT;IN:TR;IN:2PL.II;OUT:ROOT;OUT:3.II
woowaXa'm_dils	woK	X;IN:ROOT;IN:PL;IN:1PL.II;OUT:ROOT
wil'naat'ehl_lukwdiit	wil'naat'ahldiit	X;IN:ROOT;OUT:ROOT;OUT:3PL.II
jaXjoGo'm_amGoo	joK	X;IN:ROOT;IN:PL;IN:1PL.II;OUT:ROOT
dibekwt_hapdiit	dibakwdiit	X;IN:ROOT;IN:PL;IN:3.II;OUT:ROOT;OUT:PL;OUT:3PL.II
jebi'y_didalGan	jebin	X;IN:ROOT;IN:TR;IN:1SG.II;OUT:ROOT;OUT:TR;OUT:2SG.II
Gos_sdilt	Gost	X;IN:ROOT;OUT:ROOT;OUT:3.II
waatxwit_wil'naat'ahldiit	waatxwdiit	X;IN:ROOT;IN:SX;OUT:ROOT;OUT:3PL.II
wili'y_wilsi'm	wilsi'm	X;IN:ROOT;IN:1SG.II;OUT:ROOT;OUT:2PL.II
Gabiit_noXt	Gabiit	X;IN:ROOT;IN:SX;OUT:ROOT;OUT:3.II
laXyibit_maa'yi'm	laXyibi'm	X;IN:ROOT;IN:SX;OUT:ROOT;OUT:1PL.II
ts'uusgi'y_gwalgwa	ts'uusgim	X;IN:ROOT;IN:1SG.II;OUT:ROOT;OUT:ATTR
a'laX_da'aKhlxwin	a'laXan	X;IN:ROOT;OUT:ROOT;OUT:2SG.II
saabekwdiit_Goldiit	saabekwdiit	X;IN:ROOT;IN:PL;IN:3PL.II;OUT:ROOT;OUT:PL;OUT:3PL.II
gwiiseeK_wilplaahlt	gwiiseeKt	X;IN:ROOT;IN:PL;OUT:ROOT;OUT:PL;OUT:3.II
huwilpt_hlk'uba	huwilp	X;IN:ROOT;IN:PL;IN:3.II;OUT:ROOT;OUT:PL
wa'm_ksi'wa	we	X;IN:ROOT;IN:1PL.II;OUT:ROOT
bagu'm_jipjepdiit	bekwdiit	X;IN:ROOT;IN:PL;IN:1PL.II;OUT:ROOT;OUT:PL;OUT:3PL.II
mihas'us_bitxw	ma'us	X;IN:ROOT;IN:PL;OUT:ROOT
bekwt_hlo'o'm	bagu'm	X;IN:ROOT;IN:PL;IN:3.II;OUT:ROOT;OUT:PL;OUT:1PL.II
wanit_t'ehldiit	wendiit	X;IN:ROOT;IN:PL;IN:SX;OUT:ROOT;OUT:PL;OUT:3PL.II
wilaaxdiit_tk'idaa'whl	halaa	X;IN:ROOT;IN:3PL.II;OUT:ROOT
silget_laXyibi'm	silgedi'm	X;IN:ROOT;OUT:ROOT;OUT:1PL.II
jep_hlo'odiit	japdiit	X;IN:ROOT;OUT:ROOT;OUT:3PL.II
saGaytGoodindiit_wilpt	saGaytGoodint	X;IN:ROOT;IN:3PL.II;OUT:ROOT;OUT:3.II
xseeK_tk'idaa'whl	xsaxw	X;IN:ROOT;IN:PL;OUT:ROOT
Xpts'ewi'y_daa'whl	Xpts'exw	X;IN:ROOT;IN:1SG.II;OUT:ROOT
am'amt_a'laXt	amt	X;IN:ROOT;IN:PL;IN:3.II;OUT:ROOT;OUT:3.II
ayooKt_lukw	ayooK	X;IN:ROOT;IN:3.II;OUT:ROOT
ts'ehlXdiit_t'ahl	hishalaagaX	X;IN:ROOT;IN:3PL.II;OUT:ROOT;OUT:PL
seksit_mihas'us	saks	X;IN:ROOT;IN:PL;IN:SX;OUT:ROOT;OUT:PL
amt_Xsdaat	amit	X;IN:ROOT;IN:3.II;OUT:ROOT;OUT:SX
Goodi'm_luuwent	GaGoott	X;IN:ROOT;IN:1PL.II;OUT:ROOT;OUT:PL;OUT:3.II
want_hisyetst	went	X;IN:ROOT;IN:PL;IN:SX;OUT:ROOT;OUT:PL;OUT:3.II
hugwaXt_loGa	hogaXam	X;IN:ROOT;IN:3.II;OUT:ROOT;OUT:ATTR
dexw_daa'whlit	'nu'wit	X;IN:ROOT;IN:PL;OUT:ROOT;OUT:SX
hlgim_gemgim	hlguuhlxum	X;IN:ROOT;IN:PL;IN:ATTR;OUT:ROOT;OUT:ATTR
'alGal_gidiidoKt	al'alGalt	X;IN:ROOT;OUT:ROOT;OUT:PL;OUT:3.II
bakw_'nu'wit	'witxwit	X;IN:ROOT;IN:PL;OUT:ROOT;OUT:SX
Galts'ebi'm_gidiidoK	Galjipts'ep	X;IN:ROOT;IN:1PL.II;OUT:ROOT;OUT:PL
hasaKsi'm_wilKdiit	hasaKdiit	X;IN:ROOT;IN:2PL.II;OUT:ROOT;OUT:3PL.II
gigiinuxw_hasaKdiit	gigiinuxwdiit	X;IN:ROOT;OUT:ROOT;OUT:3PL.II
giihlt_hap	laahl	X;IN:ROOT;IN:3.II;OUT:ROOT;OUT:PL
t'aXt_ubin	t'aX	X;IN:ROOT;IN:3.II;OUT:ROOT
went_Galjipts'ep	wen	X;IN:ROOT;IN:PL;IN:3.II;OUT:ROOT;OUT:PL
joGo'm_la	joK	X;IN:ROOT;IN:1PL.II;OUT:ROOT
hooyi'm_laX'ut	hooxt	X;IN:ROOT;IN:TR;IN:1PL.II;OUT:ROOT;OUT:3.II
GasGoot_laXyibit	GasGoot	X;IN:ROOT;IN:3.II;OUT:ROOT;OUT:SX
'nu'wt_wat	'nu'wt	X;IN:ROOT;IN:3.II;OUT:ROOT;OUT:SX
dew_niiniks	dewdew	X;IN:ROOT;OUT:ROOT;OUT:PL
Ganaa'w_t'ak'int	Ganaa'wt	X;IN:ROOT;OUT:ROOT;OUT:3.II
nakst_twa'lixs	neks	X;IN:ROOT;IN:3.II;OUT:ROOT
silgedi'm_'weesxw	silget	X;IN:ROOT;IN:1PL.II;OUT:ROOT
Gabiit_t'is	Gabii	X;IN:ROOT;IN:SX;OUT:ROOT
jaXjoGat_saalukwdiit	joKdiit	X;IN:ROOT;IN:PL;IN:SX;OUT:ROOT;OUT:3PL.II
'wint_hlimoo	'win	X;IN:ROOT;IN:3.II;OUT:ROOT
mihas'us_sise'en	mihas'usin	X;IN:ROOT;IN:PL;OUT:ROOT;OUT:PL;OUT:2SG.II
hahla'lsdi'y_yee'm	hahle'lsdi'm	X;IN:ROOT;IN:1SG.II;OUT:ROOT;OUT:1PL.II
wilsi'm_sdik'eegwin	win	X;IN:ROOT;IN:2PL.II;OUT:ROOT;OUT:2SG.II
gwiiseeKt_gigeeni	guseeK	X;IN:ROOT;IN:PL;IN:3.II;OUT:ROOT
loot_t'ipXaat	gyoo	X;IN:ROOT;IN:PL;IN:3.II;OUT:ROOT
'nu'w_t'isit	'nu'wit	X;IN:ROOT;OUT:ROOT;OUT:SX
laXyibi'm_iwit	laXyibit	X;IN:ROOT;IN:1PL.II;OUT:ROOT;OUT:SX
ts'uusgim_etxw	ts'uus	X;IN:ROOT;IN:ATTR;OUT:ROOT
went_lit	wen	X;IN:ROOT;IN:PL;IN:SX;OUT:ROOT;OUT:PL
GedaXdiit_hasaGa'm	gidaXa'm	X;IN:ROOT;IN:3PL.II;OUT:ROOT;OUT:1PL.II
hlguuhlxwi'yaa_am'ama	hlgim	X;IN:ROOT;IN:1SG.II;OUT:ROOT;OUT:PL;OUT:ATTR
tXalpX_deli'm	tXalpXu'm	X;IN:ROOT;OUT:ROOT;OUT:1PL.II
gidaXdiit_yeet	gidaXt	X;IN:ROOT;IN:3PL.II;OUT:ROOT;OUT:3.II
masxwt_gipaykw	mismesxw	X;IN:ROOT;IN:3.II;OUT:ROOT;OUT:PL
wilda_jiipt	wilt	X;IN:ROOT;IN:3PL;OUT:ROOT;OUT:3.II
went_gigi'ydiit	wendiit	X;IN:ROOT;IN:PL;IN:3.II;OUT:ROOT;OUT:PL;OUT:3PL.II
algaX_'wadiit	algaXdiit	X;IN:ROOT;OUT:ROOT;OUT:3PL.II
laahli'm_Goodi'y	giihli'y	X;IN:ROOT;IN:PL;IN:1PL.II;OUT:ROOT;OUT:1SG.II
hlo'ot_k'i'lixs	yee	X;IN:ROOT;IN:PL;IN:SX;OUT:ROOT
he'y_noXo'm	he'm	X;IN:ROOT;IN:1SG.II;OUT:ROOT;OUT:1PL.II
wen_huksin	t'aan	X;IN:ROOT;IN:PL;OUT:ROOT;OUT:2SG.II
'nu'wt_baGadilt	'nu'wit	X;IN:ROOT;IN:3.II;OUT:ROOT;OUT:SX
Goldiit_Xsikst	baXt	X;IN:ROOT;IN:PL;IN:3PL.II;OUT:ROOT;OUT:3.II
bakw_mas'usi'm	bagu'm	X;IN:ROOT;IN:PL;OUT:ROOT;OUT:PL;OUT:1PL.II
ga'adiit_hooyi'm	ga'a'm	X;IN:ROOT;IN:3PL.II;OUT:ROOT;OUT:TR;OUT:1PL.II
hiji'm_dildilsdiit	hashetsdiit	X;IN:ROOT;IN:1PL.II;OUT:ROOT;OUT:PL;OUT:3PL.II
bekwdiit_hlo'o'm	bagu'm	X;IN:ROOT;IN:PL;IN:3PL.II;OUT:ROOT;OUT:PL;OUT:1PL.II
ga'a_hit'int	ga'at	X;IN:ROOT;OUT:ROOT;OUT:TR;OUT:3.II
nakst_uu'wt	nekst	X;IN:ROOT;IN:3.II;OUT:ROOT;OUT:3.II
wildiit_saGaytGootda	wilda	X;IN:ROOT;IN:3PL.II;OUT:ROOT;OUT:3PL
baGadili'm_ayukws	baGadil	X;IN:ROOT;IN:1PL.II;OUT:ROOT
guu_GaGoott	doKt	X;IN:ROOT;OUT:ROOT;OUT:PL;OUT:3.II
wandiit_luujoGat	t'aat	X;IN:ROOT;IN:PL;IN:3PL.II;OUT:ROOT;OUT:SX
nigwoott_lukw	nigwoot	X;IN:ROOT;IN:3.II;OUT:ROOT
ga'a'm_a'widiit	ga'adiit	X;IN:ROOT;IN:TR;IN:1PL.II;OUT:ROOT;OUT:3PL.II
a'laXt_Xmaa'yi'm	a'laXa'm	X;IN:ROOT;IN:3.II;OUT:ROOT;OUT:1PL.II
noXon_da'aKhlxwi'y	noho'y	X;IN:ROOT;IN:2SG.II;OUT:ROOT;OUT:1SG.II
gwiladiit_daXgedi'm	gwila'm	X;IN:ROOT;IN:3PL.II;OUT:ROOT;OUT:1PL.II
silgetdiit_ga'a'm	silgedi'm	X;IN:ROOT;IN:3PL.II;OUT:ROOT;OUT:1PL.II
Xdeyi'm_gigiinuxw	Xde	X;IN:ROOT;IN:1PL.II;OUT:ROOT
'wadiit_gubi'm	'wayi'm	X;IN:ROOT;IN:3PL.II;OUT:ROOT;OUT:TR;OUT:1PL.II
gatt_saGaytGooda	gat	X;IN:ROOT;IN:3.II;OUT:ROOT
saksdiit_hal'olaXat	saksit	X;IN:ROOT;IN:PL;IN:3PL.II;OUT:ROOT;OUT:PL;OUT:SX
heltt_jakw	helt	X;IN:ROOT;IN:3.II;OUT:ROOT
waatxwt_K'oo'ldit	waatxwit	X;IN:ROOT;IN:3.II;OUT:ROOT;OUT:SX
joGo'y_hlo'o'm	jaXjoGo'm	X;IN:ROOT;IN:1SG.II;OUT:ROOT;OUT:PL;OUT:1PL.II
t'aa_huut	wan	X;IN:ROOT;OUT:ROOT;OUT:PL
ayawaatxwt_xsaxw	ayawaatxw	X;IN:ROOT;IN:3.II;OUT:ROOT
woowaXa'm_Gado'ot	woKt	X;IN:ROOT;IN:PL;IN:1PL.II;OUT:ROOT;OUT:3.II
dibakwdiit_disekst	dibekwt	X;IN:ROOT;IN:PL;IN:3PL.II;OUT:ROOT;OUT:PL;OUT:3.II
aluugiget_ii'wxwt	aluugiget	X;IN:ROOT;IN:PL;OUT:ROOT;OUT:PL
t'aham_suuhlo'odiit	t'aXdiit	X;IN:ROOT;IN:ATTR;OUT:ROOT;OUT:3PL.II
laXyip_yeet	laXyibit	X;IN:ROOT;OUT:ROOT;OUT:SX
t'ihlxw_gipaygum	tk'ihlxum	X;IN:ROOT;OUT:ROOT;OUT:ATTR
'mast_ha'niiGoodi'y	'masi'y	X;IN:ROOT;IN:3.II;OUT:ROOT;OUT:1SG.II
gidaX_yuwit	gidaXat	X;IN:ROOT;OUT:ROOT;OUT:TR;OUT:3.II
dexwt_k'i'yt	'nu'wit	X;IN:ROOT;IN:PL;IN:3.II;OUT:ROOT;OUT:SX
'witxwi'y_mas'usi'm	bagu'm	X;IN:ROOT;IN:1SG.II;OUT:ROOT;OUT:PL;OUT:1PL.II
hlo'ot_saks	hlo'o	X;IN:ROOT;IN:PL;IN:3.II;OUT:ROOT;OUT:PL
joGo'y_GasGoot	joKt	X;IN:ROOT;IN:1SG.II;OUT:ROOT;OUT:3.II
ha'niiGoodi'y_'windiit	ha'niiGootdiit	X;IN:ROOT;IN:1SG.II;OUT:ROOT;OUT:3PL.II
daXgedi'm_haky'o'o	daXgat	X;IN:ROOT;IN:1PL.II;OUT:ROOT
t'isit_lim'oo'yt	t'ist	X;IN:ROOT;IN:SX;OUT:ROOT;OUT:3.II
went_K'oo'ldit	t'aat	X;IN:ROOT;IN:PL;IN:3.II;OUT:ROOT;OUT:SX
hlguts'uusgi'y_Xpts'exw	hlguts'uus	X;IN:ROOT;IN:1SG.II;OUT:ROOT
jaXjoGot_huudi'm	jaXjoGo'm	X;IN:ROOT;IN:PL;IN:SX;OUT:ROOT;OUT:PL;OUT:1PL.II
'nu'wt_bitxwit	'nu'wit	X;IN:ROOT;IN:SX;OUT:ROOT;OUT:SX
'wint_'wadiit	'windiit	X;IN:ROOT;IN:3.II;OUT:ROOT;OUT:3PL.II
ayukws_nibibi'm	ayukwsi'm	X;IN:ROOT;OUT:ROOT;OUT:1PL.II
'nu'wdiit_sgit	'nu'wt	X;IN:ROOT;IN:3PL.II;OUT:ROOT;OUT:SX
daa'whlit_am'amit	seksit	X;IN:ROOT;IN:SX;OUT:ROOT;OUT:PL;OUT:SX
t'aXdiit_Getxwt	t'aXt	X;IN:ROOT;IN:3PL.II;OUT:ROOT;OUT:3.II
Goodi'y_'wits'indiit	Gootdiit	X;IN:ROOT;IN:1SG.II;OUT:ROOT;OUT:3PL.II
yee_t'ekt	yeet	X;IN:ROOT;OUT:ROOT;OUT:3.II
hlgim_Ganaa'wi'y	hlguuhlxwi'yaa	X;IN:ROOT;IN:PL;IN:ATTR;OUT:ROOT;OUT:1SG.II
joGo'm_anooKdiit	joKdiit	X;IN:ROOT;IN:1PL.II;OUT:ROOT;OUT:3PL.II
aamit_sinhunt	amit	X;IN:ROOT;IN:SX;OUT:ROOT;OUT:SX
hahle'lstdiit_K'oo'ldit	hahle'lsit	X;IN:ROOT;IN:3PL.II;OUT:ROOT;OUT:SX
a'laXdiit_nigwoodi'm	a'laXa'm	X;IN:ROOT;IN:3PL.II;OUT:ROOT;OUT:1PL.II
daha'wt_luut'ipdaa'wt	daha'wit	X;IN:ROOT;IN:3.II;OUT:ROOT;OUT:3.II
t'aXt_aluugiget	dit'aX	X;IN:ROOT;IN:3.II;OUT:ROOT;OUT:PL
alisxw_isi'm	alisxu'm	X;IN:ROOT;OUT:ROOT;OUT:1PL.II
kwsdinst_yats	kwsdins	X;IN:ROOT;IN:3.II;OUT:ROOT
baK_kw'oodini'm	baGa'm	X;IN:ROOT;OUT:ROOT;OUT:TR;OUT:1PL.II
Xsdaat_toosdiit	Xsdaadiit	X;IN:ROOT;IN:SX;OUT:ROOT;OUT:3PL.II
we_hlgit	huwat	X;IN:ROOT;OUT:ROOT;OUT:PL;OUT:3.II
joK_dildilsit	jaXjoGat	X;IN:ROOT;OUT:ROOT;OUT:PL;OUT:SX
da'aKhlxw_giihli'y	da'aKhlxwi'y	X;IN:ROOT;OUT:ROOT;OUT:1SG.II
hahle'lst_luujoGat	hahla'ljit	X;IN:ROOT;IN:3.II;OUT:ROOT;OUT:SX
wilpdiit_saGaytGootin	wilp	X;IN:ROOT;IN:3PL.II;OUT:ROOT
dildilsit_doKdiit	dildilsdiit	X;IN:ROOT;IN:PL;IN:SX;OUT:ROOT;OUT:PL;OUT:3PL.II
ga'at_ts'iibit	ga'at	X;IN:ROOT;IN:3.II;OUT:ROOT;OUT:TR;OUT:3.II
huwilaa_kw'esini'y	wilaayi'y	X;IN:ROOT;IN:PL;OUT:ROOT;OUT:TR;OUT:1SG.II
waatxw_wilpt	waatxwt	X;IN:ROOT;OUT:ROOT;OUT:3.II
dikw'itxw_ts'o'oXsdiit	di'witxwdiit	X;IN:ROOT;OUT:ROOT;OUT:3PL.II
wadiit_sinhunt	wat	X;IN:ROOT;IN:3PL.II;OUT:ROOT;OUT:SX
want_wani'm	weni'm	X;IN:ROOT;IN:PL;IN:3.II;OUT:ROOT;OUT:PL;OUT:1PL.II
hlgidiit_hlgi'y	hlgi'y	X;IN:ROOT;IN:PL;IN:3PL.II;OUT:ROOT;OUT:PL;OUT:1SG.II
bekwt_sgit	'witxwit	X;IN:ROOT;IN:PL;IN:3.II;OUT:ROOT;OUT:SX
doGot_huudini'm	doGo'm	X;IN:ROOT;IN:PL;IN:TR;IN:3.II;OUT:ROOT;OUT:PL;OUT:TR;OUT:1PL.II
jiksin_aksdiit	jiksindiit	X;IN:ROOT;OUT:ROOT;OUT:3PL.II
Go'o_wilsi'm	Go'osi'm	X;IN:ROOT;OUT:ROOT;OUT:2PL.II
Xpts'exw_niye'e'y	Xpts'ewi'y	X;IN:ROOT;OUT:ROOT;OUT:1SG.II
gwilan_hlimoo'ldiit	gwiladiit	X;IN:ROOT;IN:2SG.II;OUT:ROOT;OUT:3PL.II
wiyitxw_Xsdaadiit	wiyitsxwdiit	X;IN:ROOT;OUT:ROOT;OUT:3PL.II
hlguuhlxum_gwiiseeKt	hlgit	X;IN:ROOT;IN:ATTR;OUT:ROOT;OUT:PL;OUT:3.II
algaXt_ma'usi'y	algaXa'y	X;IN:ROOT;IN:3.II;OUT:ROOT;OUT:1SG.II
saksit_huwat	sekst	X;IN:ROOT;IN:PL;IN:SX;OUT:ROOT;OUT:PL;OUT:3.II
bekwt_laahldiit	bekwdiit	X;IN:ROOT;IN:PL;IN:3.II;OUT:ROOT;OUT:PL;OUT:3PL.II
ga'adiit_luuwendindiit	gitga'adiit	X;IN:ROOT;IN:3PL.II;OUT:ROOT;OUT:PL;OUT:3PL.II
t'aX_laX'nidiit	t'aXdiit	X;IN:ROOT;OUT:ROOT;OUT:3PL.II
K'ots_saGaytGoodindiit	K'otsdiit	X;IN:ROOT;OUT:ROOT;OUT:3PL.II
ga'adiit_yuwit	ga'at	X;IN:ROOT;IN:3PL.II;OUT:ROOT;OUT:TR;OUT:3.II
hlimoo'm_'wayi'm	hlimooyi'm	X;IN:ROOT;IN:1PL.II;OUT:ROOT;OUT:TR;OUT:1PL.II
t'ilXoo'y_hedindiit	t'ilXo'odiit	X;IN:ROOT;IN:1SG.II;OUT:ROOT;OUT:3PL.II
daa'whlt_diyeet	daa'wihlt	X;IN:ROOT;IN:3.II;OUT:ROOT;OUT:3.II
get_het	gett	X;IN:ROOT;OUT:ROOT;OUT:3.II
jaXjoKdiit_ayukwsdiit	joKdiit	X;IN:ROOT;IN:PL;IN:3PL.II;OUT:ROOT;OUT:3PL.II
doX_gilbil	sgi	X;IN:ROOT;IN:PL;OUT:ROOT
guts'uusgi'y_hlooGo'm	guts'uusgi'm	X;IN:ROOT;IN:1SG.II;OUT:ROOT;OUT:1PL.II
dils_laahli'm	didilsdi'm	X;IN:ROOT;OUT:ROOT;OUT:PL;OUT:1PL.II
smaxt_maKdiit	smaxdiit	X;IN:ROOT;IN:3.II;OUT:ROOT;OUT:3PL.II
joGat_gigi'ydiit	jaXjoKdiit	X;IN:ROOT;IN:SX;OUT:ROOT;OUT:PL;OUT:3PL.II
loGom_loGa	loGa	X;IN:ROOT;IN:ATTR;OUT:ROOT;OUT:ATTR
he'm_luujoGat	heet	X;IN:ROOT;IN:1PL.II;OUT:ROOT;OUT:SX
Goli'm_hunt	baXt	X;IN:ROOT;IN:PL;IN:1PL.II;OUT:ROOT;OUT:3.II
a'laXt_didi'y	a'laX	X;IN:ROOT;IN:3.II;OUT:ROOT
amt_dukhlinX	am	X;IN:ROOT;IN:3.II;OUT:ROOT
we_gemkt	wat	X;IN:ROOT;OUT:ROOT;OUT:3.II
doKt_doGot	doGot	X;IN:ROOT;IN:PL;IN:3.II;OUT:ROOT;OUT:PL;OUT:TR;OUT:3.II
gwiladiit_ts'uuts't	gwilat	X;IN:ROOT;IN:3PL.II;OUT:ROOT;OUT:3.II
ayukws_hapt	ayukwst	X;IN:ROOT;OUT:ROOT;OUT:3.II
hloXsa_gi'yt	hloXst	X;IN:ROOT;IN:ATTR;OUT:ROOT;OUT:3.II
heltt_baGadilda	heltda	X;IN:ROOT;IN:3.II;OUT:ROOT;OUT:3PL
doKt_huudini'm	doGo'm	X;IN:ROOT;IN:PL;IN:3.II;OUT:ROOT;OUT:PL;OUT:TR;OUT:1PL.II
wilt_he'y	wili'y	X;IN:ROOT;IN:SX;OUT:ROOT;OUT:1SG.II
wilt_jemdiit	wildiit	X;IN:ROOT;IN:3.II;OUT:ROOT;OUT:3PL.II
doKdiit_doXt	doKt	X;IN:ROOT;IN:PL;IN:3PL.II;OUT:ROOT;OUT:PL;OUT:3.II
'witxwit_lidint	bekwt	X;IN:ROOT;IN:SX;OUT:ROOT;OUT:PL;OUT:3.II
t'aa_dexwit	want	X;IN:ROOT;OUT:ROOT;OUT:PL;OUT:SX
gigiinuxw_Goodin	gigiinuxwin	X;IN:ROOT;OUT:ROOT;OUT:2SG.II
saalukwdiit_'nu'wdiit	saalukwdiit	X;IN:ROOT;IN:3PL.II;OUT:ROOT;OUT:3PL.II
jebi'y_wilaayisi'm	jebisi'm	X;IN:ROOT;IN:TR;IN:1SG.II;OUT:ROOT;OUT:TR;OUT:2PL.II
t'ilXo'odiit_ha'win	t'ilXoo	X;IN:ROOT;IN:3PL.II;OUT:ROOT
a'laXa'm_saalukwdiit	a'laXdiit	X;IN:ROOT;IN:1PL.II;OUT:ROOT;OUT:3PL.II
daa'whl_hlo'ot	seksit	X;IN:ROOT;OUT:ROOT;OUT:PL;OUT:SX
Gabiit_wat	Gabit	X;IN:ROOT;IN:SX;OUT:ROOT;OUT:SX
gidiidoKdiit_ha'niilaahl	gidiidoK	X;IN:ROOT;IN:PL;IN:3PL.II;OUT:ROOT;OUT:PL
Goodin_Ge'ndiit	Gootdiit	X;IN:ROOT;IN:2SG.II;OUT:ROOT;OUT:3PL.II
ixw_sgit	iwit	X;IN:ROOT;OUT:ROOT;OUT:SX
Galts'epdiit_algaXa'm	Galts'ebi'm	X;IN:ROOT;IN:3PL.II;OUT:ROOT;OUT:1PL.II
jepdiit_wilksisxw	jep	X;IN:ROOT;IN:3PL.II;OUT:ROOT
Xsdaa_ixwt	Xsdaat	X;IN:ROOT;OUT:ROOT;OUT:3.II
doXdiit_GasGoot	sgit	X;IN:ROOT;IN:PL;IN:3PL.II;OUT:ROOT;OUT:SX
want_wani'm	wani'm	X;IN:ROOT;IN:PL;IN:SX;OUT:ROOT;OUT:PL;OUT:1PL.II
Goott_luut'ehldiit	GaGootdiit	X;IN:ROOT;IN:3.II;OUT:ROOT;OUT:PL;OUT:3PL.II
hasaKsi'm_waa	hasaK	X;IN:ROOT;IN:2PL.II;OUT:ROOT
daa'whlit_ubint	daa'whlt	X;IN:ROOT;IN:SX;OUT:ROOT;OUT:3.II
Goodi'm_nee	Goot	X;IN:ROOT;IN:1PL.II;OUT:ROOT
'witxwi'y_gipaykwt	bekwt	X;IN:ROOT;IN:1SG.II;OUT:ROOT;OUT:PL;OUT:3.II
ayukwsim_hlist	ayukwst	X;IN:ROOT;IN:ATTR;OUT:ROOT;OUT:3.II
hasaKdiit_hligu'm	hasaGa'm	X;IN:ROOT;IN:3PL.II;OUT:ROOT;OUT:1PL.II
joKdiit_uu'wt	joKt	X;IN:ROOT;IN:3PL.II;OUT:ROOT;OUT:3.II
joGat_'nu'wdiit	joKdiit	X;IN:ROOT;IN:SX;OUT:ROOT;OUT:3PL.II
wandiit_mas'usi'm	weni'm	X;IN:ROOT;IN:PL;IN:3PL.II;OUT:ROOT;OUT:PL;OUT:1PL.II
gidaXat_t'imGest	gidaXt	X;IN:ROOT;IN:TR;IN:3.II;OUT:ROOT;OUT:3.II
t'aan_gidiidoK	wan	X;IN:ROOT;IN:2SG.II;OUT:ROOT;OUT:PL
'windiit_gint	'wint	X;IN:ROOT;IN:3PL.II;OUT:ROOT;OUT:3.II
t'aat_dibakwdiit	wandiit	X;IN:ROOT;IN:SX;OUT:ROOT;OUT:PL;OUT:3PL.II
dexwdiit_Xpts'exw	'nu'w	X;IN:ROOT;IN:PL;IN:3PL.II;OUT:ROOT
hlo'o_hunt	yeet	X;IN:ROOT;IN:PL;OUT:ROOT;OUT:3.II
jebisi'm_tK'a'andiit	jepdiit	X;IN:ROOT;IN:TR;IN:2PL.II;OUT:ROOT;OUT:3PL.II
ky'uldiit_naX'nit	ky'ult	X;IN:ROOT;IN:3PL.II;OUT:ROOT;OUT:3.II
wendiit_ayawaatxwt	t'aat	X;IN:ROOT;IN:PL;IN:3PL.II;OUT:ROOT;OUT:3.II
'wat_gubi'm	'wayi'm	X;IN:ROOT;IN:3.II;OUT:ROOT;OUT:TR;OUT:1PL.II
gwilat_Galts'ebi'm	gwila'm	X;IN:ROOT;IN:3.II;OUT:ROOT;OUT:1PL.II
t'aam_hen	t'aan	X;IN:ROOT;IN:ATTR;OUT:ROOT;OUT:2SG.II
jep_yuwi'y	jebi'y	X;IN:ROOT;OUT:ROOT;OUT:TR;OUT:1SG.II
daXgat_gwalgwa	daXgadim	X;IN:ROOT;OUT:ROOT;OUT:ATTR
joKdiit_dohot	jaXjoGat	X;IN:ROOT;IN:3PL.II;OUT:ROOT;OUT:PL;OUT:SX
sekst_gitga'adiit	saksdiit	X;IN:ROOT;IN:PL;IN:3.II;OUT:ROOT;OUT:PL;OUT:3PL.II
hlgim_saGaytGoodain	hlguuhlxw	X;IN:ROOT;IN:PL;IN:ATTR;OUT:ROOT
woK_aliisxu'm	woowaXa'm	X;IN:ROOT;OUT:ROOT;OUT:PL;OUT:1PL.II
baKdiit_ts'eehl	baK	X;IN:ROOT;IN:3PL.II;OUT:ROOT
algaXa'y_hlaahlaXtt	hal'algaXt	X;IN:ROOT;IN:1SG.II;OUT:ROOT;OUT:PL;OUT:3.II
Goodi'y_hishalaagaXdiit	GaGootdiit	X;IN:ROOT;IN:1SG.II;OUT:ROOT;OUT:PL;OUT:3PL.II
gup_sibint	gubit	X;IN:ROOT;OUT:ROOT;OUT:TR;OUT:3.II
jipjepdiit_heltt	japt	X;IN:ROOT;IN:PL;IN:3PL.II;OUT:ROOT;OUT:3.II
hahle'lst_gitxsdiit	hahle'lstdiit	X;IN:ROOT;OUT:ROOT;OUT:3PL.II
guu_ii'wxwt	doK	X;IN:ROOT;OUT:ROOT;OUT:PL
guseeGat_aliisxw	gwiiseeK	X;IN:ROOT;IN:TR;IN:3.II;OUT:ROOT;OUT:PL
hogaX_limxt	hogaXt	X;IN:ROOT;OUT:ROOT;OUT:3.II
jabi'y_nigwootdiit	jepdiit	X;IN:ROOT;IN:TR;IN:1SG.II;OUT:ROOT;OUT:3PL.II
simgigat_dewdew	simgiget	X;IN:ROOT;IN:PL;OUT:ROOT;OUT:PL
daXgett_K'ojam	daXgadim	X;IN:ROOT;IN:3.II;OUT:ROOT;OUT:ATTR
hen_hlo'o'm	he'm	X;IN:ROOT;IN:2SG.II;OUT:ROOT;OUT:1PL.II
Xa'nit_am	naX'ni	X;IN:ROOT;IN:3.II;OUT:ROOT
jipjepdiit_gipaykwdiit	jepdiit	X;IN:ROOT;IN:PL;IN:3PL.II;OUT:ROOT;OUT:3PL.II
hap_gubit	tK'esxwit	X;IN:ROOT;IN:PL;OUT:ROOT;OUT:TR;OUT:3.II
gipaykwt_ts'ee'w	gipaykw	X;IN:ROOT;IN:PL;IN:3.II;OUT:ROOT
gwiiladiit_hlXo'o	gwila	X;IN:ROOT;IN:PL;IN:3PL.II;OUT:ROOT
heltdiit_daGo'odim	heldim	X;IN:ROOT;IN:3PL.II;OUT:ROOT;OUT:ATTR
huutdiit_tXooGant	huutt	X;IN:ROOT;IN:PL;IN:3PL.II;OUT:ROOT;OUT:PL;OUT:3.II
daa'whldiit_ansdo'ot	daa'whlt	X;IN:ROOT;IN:3PL.II;OUT:ROOT;OUT:3.II
aluut'aa_limxt	aluut'aat	X;IN:ROOT;OUT:ROOT;OUT:3.II
Go'o_da'aKhlxwdiit	Go'odiit	X;IN:ROOT;OUT:ROOT;OUT:3PL.II
guseeKt_'mootxwit	guseeGat	X;IN:ROOT;IN:3.II;OUT:ROOT;OUT:TR;OUT:3.II
hogaGam_hlamst	hugwaXt	X;IN:ROOT;IN:ATTR;OUT:ROOT;OUT:3.II
wani'm_laXyibit	t'aat	X;IN:ROOT;IN:PL;IN:1PL.II;OUT:ROOT;OUT:SX
t'is_gidaXt	t'ist	X;IN:ROOT;OUT:ROOT;OUT:3.II
yetst_saabekwt	hisyetst	X;IN:ROOT;IN:3.II;OUT:ROOT;OUT:PL;OUT:3.II
ayooKdiit_pole	ayooK	X;IN:ROOT;IN:3PL.II;OUT:ROOT
t'aam_doX	wen	X;IN:ROOT;IN:ATTR;OUT:ROOT;OUT:PL
yuwit_'nii'wadiit	yuxwdiit	X;IN:ROOT;IN:TR;IN:3.II;OUT:ROOT;OUT:3PL.II
baas_kw'esini'y	baasxi'y	X;IN:ROOT;OUT:ROOT;OUT:TR;OUT:1SG.II
uu'wt_Goyp'aXt	uu'wit	X;IN:ROOT;IN:3.II;OUT:ROOT;OUT:3.II
t'aat_mas'usi'm	wani'm	X;IN:ROOT;IN:3.II;OUT:ROOT;OUT:PL;OUT:1PL.II
'nu'w_gigi'ydiit	dexwdiit	X;IN:ROOT;OUT:ROOT;OUT:PL;OUT:3PL.II
went_gigiinuxwin	t'aan	X;IN:ROOT;IN:PL;IN:SX;OUT:ROOT;OUT:2SG.II
midint_midindiit	midindiit	X;IN:ROOT;IN:3.II;OUT:ROOT;OUT:3PL.II
Gost_Gosi'm	Gosi'm	X;IN:ROOT;IN:3.II;OUT:ROOT;OUT:TR;OUT:1PL.II
liluxwsdiit_liluxwsisi'm	liluxwsisi'm	X;IN:ROOT;IN:3PL.II;OUT:ROOT;OUT:2PL.II
wili'y_anooGo'm	wili'm	X;IN:ROOT;IN:1SG.II;OUT:ROOT;OUT:1PL.II
wanit_saksit	went	X;IN:ROOT;IN:PL;IN:SX;OUT:ROOT;OUT:PL;OUT:SX
amit_k'i'yt	aamit	X;IN:ROOT;IN:SX;OUT:ROOT;OUT:SX
wilaayit_hasaKt	halaaxt	X;IN:ROOT;IN:TR;IN:3.II;OUT:ROOT;OUT:3.II
'witxwt_lidindiit	bekwdiit	X;IN:ROOT;IN:3.II;OUT:ROOT;OUT:PL;OUT:3PL.II
het_ayooKdiit	hediit	X;IN:ROOT;IN:3.II;OUT:ROOT;OUT:3PL.II
halaaxt_baasxi'y	wilaayi'y	X;IN:ROOT;IN:3.II;OUT:ROOT;OUT:TR;OUT:1SG.II
jebin_jebisi'm	jebisi'm	X;IN:ROOT;IN:TR;IN:2SG.II;OUT:ROOT;OUT:TR;OUT:2PL.II
wan_tK'alyeet	t'aat	X;IN:ROOT;IN:PL;OUT:ROOT;OUT:3.II
noX_a'laXan	noXon	X;IN:ROOT;OUT:ROOT;OUT:2SG.II
ga'at_Xa'nii'y	ga'a'y	X;IN:ROOT;IN:3.II;OUT:ROOT;OUT:TR;OUT:1SG.II
dewdew_kwsdinst	dawt	X;IN:ROOT;IN:PL;OUT:ROOT;OUT:3.II
hahle'lstdiit_hligu'm	hahle'lsdi'm	X;IN:ROOT;IN:3PL.II;OUT:ROOT;OUT:1PL.II
Galts'ap_K'ay'mesi'y	Galts'ebi'y	X;IN:ROOT;OUT:ROOT;OUT:1SG.II
woKt_ts'ee'w	woK	X;IN:ROOT;IN:3.II;OUT:ROOT
wilaaxdiit_wil'naat'ahlt	halaaxt	X;IN:ROOT;IN:3PL.II;OUT:ROOT;OUT:3.II
(K'amksiwaamX)_yuuhlimXdiit	K'amksiwaamXdiit	X;IN:ROOT;OUT:ROOT;OUT:3PL.II
yuwi'y_ga'at	yuwit	X;IN:ROOT;IN:TR;IN:1SG.II;OUT:ROOT;OUT:TR;OUT:3.II
wilt_anhahla'lsdi'y	wili'y	X;IN:ROOT;IN:3.II;OUT:ROOT;OUT:1SG.II
GaGootdiit_gwilan	Goodin	X;IN:ROOT;IN:PL;IN:3PL.II;OUT:ROOT;OUT:2SG.II
wilaayi'y_jebisi'm	wilaayisi'm	X;IN:ROOT;IN:TR;IN:1SG.II;OUT:ROOT;OUT:TR;OUT:2PL.II
gipaykw_get	gipaykw	X;IN:ROOT;IN:PL;OUT:ROOT
sGa'wadiit_t'aadindiit	sGa'wadiit	X;IN:ROOT;IN:3PL.II;OUT:ROOT;OUT:3PL.II
hasaGat_ksi'wadiit	hasaKdiit	X;IN:ROOT;IN:SX;OUT:ROOT;OUT:3PL.II
hlgi_gwalgwa	hlguuhlxum	X;IN:ROOT;IN:PL;OUT:ROOT;OUT:ATTR
ama_aamit	amit	X;IN:ROOT;IN:ATTR;OUT:ROOT;OUT:SX
Galts'epdiit_'mas	Galts'ep	X;IN:ROOT;IN:3PL.II;OUT:ROOT
t'ehl_aliisxw	t'ahl	X;IN:ROOT;IN:PL;OUT:ROOT;OUT:PL
he'm_hogaXdiit	hediit	X;IN:ROOT;IN:1PL.II;OUT:ROOT;OUT:3PL.II
luuhitxwGoot_nigwootdiit	luuhitxwGootdiit	X;IN:ROOT;OUT:ROOT;OUT:3PL.II
wanit_dewdew	wan	X;IN:ROOT;IN:PL;IN:SX;OUT:ROOT;OUT:PL
t'aat_t'isit	t'aat	X;IN:ROOT;IN:SX;OUT:ROOT;OUT:SX
japt_t'amin	jebin	X;IN:ROOT;IN:3.II;OUT:ROOT;OUT:TR;OUT:2SG.II
hlgidiit_'man	hlguuhlxw	X;IN:ROOT;IN:PL;IN:3PL.II;OUT:ROOT
gidiidoKdiit_hugwaX	gidiiguu	X;IN:ROOT;IN:PL;IN:3PL.II;OUT:ROOT
bagu'm_hlo'o	bakw	X;IN:ROOT;IN:PL;IN:1PL.II;OUT:ROOT;OUT:PL
doXdiit_sisipt	doXt	X;IN:ROOT;IN:PL;IN:3PL.II;OUT:ROOT;OUT:PL;OUT:3.II
t'aan_huudindiit	wandiit	X;IN:ROOT;IN:2SG.II;OUT:ROOT;OUT:PL;OUT:3PL.II
ha'wi'm_sGat'aa	ha'w	X;IN:ROOT;IN:1PL.II;OUT:ROOT
t'aat_ts'ee	t'aa	X;IN:ROOT;IN:SX;OUT:ROOT
daa'whlt_al'alGalt	sekst	X;IN:ROOT;IN:3.II;OUT:ROOT;OUT:PL;OUT:3.II
da'aKhlxw_sdik'eegwin	da'aKhlxwin	X;IN:ROOT;OUT:ROOT;OUT:2SG.II
nekst_gemgim	neksim	X;IN:ROOT;IN:3.II;OUT:ROOT;OUT:ATTR
dexwdiit_gipaykwt	dexwt	X;IN:ROOT;IN:PL;IN:3PL.II;OUT:ROOT;OUT:PL;OUT:3.II
hlguts'uusxt_hligu'm	guts'uusgi'm	X;IN:ROOT;IN:3.II;OUT:ROOT;OUT:1PL.II
halaa_jebisi'm	wilaayisi'm	X;IN:ROOT;OUT:ROOT;OUT:TR;OUT:2PL.II
sise'en_GatGoodindiit	sise'ediit	X;IN:ROOT;IN:PL;IN:2SG.II;OUT:ROOT;OUT:PL;OUT:3PL.II
al'alGalt_das	'alGal	X;IN:ROOT;IN:PL;IN:3.II;OUT:ROOT
am'ama_'mesim	ama	X;IN:ROOT;IN:PL;IN:ATTR;OUT:ROOT;OUT:ATTR
bakw_xsawi'y	'witxwi'y	X;IN:ROOT;IN:PL;OUT:ROOT;OUT:1SG.II
wildiit_liluxwsisi'm	wisi'm	X;IN:ROOT;IN:3PL.II;OUT:ROOT;OUT:2PL.II
Go'osi'm_ts'in	Go'o	X;IN:ROOT;IN:2PL.II;OUT:ROOT
miin_sit'aadiit	miindiit	X;IN:ROOT;OUT:ROOT;OUT:3PL.II
Goodin_lidint	GaGoott	X;IN:ROOT;IN:2SG.II;OUT:ROOT;OUT:PL;OUT:3.II
gitga'adiit_sdo'oks	ga'a	X;IN:ROOT;IN:PL;IN:3PL.II;OUT:ROOT
'mesim_am'ama	limXsim	X;IN:ROOT;IN:ATTR;OUT:ROOT;OUT:PL;OUT:ATTR
gin_aat'ikst	gint	X;IN:ROOT;OUT:ROOT;OUT:3.II
niinixs_t'aam	neksim	X;IN:ROOT;IN:PL;OUT:ROOT;OUT:ATTR
jabi'y_jebisi'm	jebisi'm	X;IN:ROOT;IN:TR;IN:1SG.II;OUT:ROOT;OUT:TR;OUT:2PL.II
guseeKt_haanaK'	gwiiseeK	X;IN:ROOT;IN:3.II;OUT:ROOT;OUT:PL
wa'm_hasaGat	wat	X;IN:ROOT;IN:1PL.II;OUT:ROOT;OUT:SX
want_loodiit	wandiit	X;IN:ROOT;IN:PL;IN:3.II;OUT:ROOT;OUT:PL;OUT:3PL.II
heltda_jem	helt	X;IN:ROOT;IN:3PL;OUT:ROOT
ha'wdiit_ha'niijoGa'm	ha'wi'm	X;IN:ROOT;IN:3PL.II;OUT:ROOT;OUT:1PL.II
'mesim_laahl	limXs	X;IN:ROOT;IN:ATTR;OUT:ROOT;OUT:PL
da'aKhlxwin_Goodi'y	da'aKhlxwi'y	X;IN:ROOT;IN:2SG.II;OUT:ROOT;OUT:1SG.II
daa'wihlt_GaGoott	sekst	X;IN:ROOT;IN:3.II;OUT:ROOT;OUT:PL;OUT:3.II
ksi'wa_'wadiit	ksi'wadiit	X;IN:ROOT;OUT:ROOT;OUT:3PL.II
'witxwi'y_masxwit	'witxwit	X;IN:ROOT;IN:1SG.II;OUT:ROOT;OUT:SX
dibakw_lem	dibekw	X;IN:ROOT;IN:PL;OUT:ROOT;OUT:PL
wiyitxw_ga'at	'wiiyitxwt	X;IN:ROOT;OUT:ROOT;OUT:3.II
gimxdi_'witxwt	gimxdit	X;IN:ROOT;OUT:ROOT;OUT:3.II
dibekwt_t'aXdiit	di'witxwdiit	X;IN:ROOT;IN:PL;IN:3.II;OUT:ROOT;OUT:3PL.II
silimxdiit_Goot	silim	X;IN:ROOT;IN:3PL.II;OUT:ROOT
t'aam_Galjipts'ep	wan	X;IN:ROOT;IN:ATTR;OUT:ROOT;OUT:PL
wan_gemgim	t'aam	X;IN:ROOT;IN:PL;OUT:ROOT;OUT:ATTR
masxwit_gwelk'ujaX	mesxw	X;IN:ROOT;IN:SX;OUT:ROOT
amit_huwat	am'amt	X;IN:ROOT;IN:SX;OUT:ROOT;OUT:PL;OUT:3.II
da'aKhlxwi'y_saGaytGoodindiit	da'aKhlxwdiit	X;IN:ROOT;IN:1SG.II;OUT:ROOT;OUT:3PL.II
doK_bahlXant	guut	X;IN:ROOT;IN:PL;OUT:ROOT;OUT:3.II
wadiit_hlguuhlxwi'y	we'y	X;IN:ROOT;IN:3PL.II;OUT:ROOT;OUT:1SG.II
hlguts'uus_silgedi'm	guts'uusgi'm	X;IN:ROOT;OUT:ROOT;OUT:1PL.II
t'ilXoo'y_saalukwdiit	t'ilXo'odiit	X;IN:ROOT;IN:1SG.II;OUT:ROOT;OUT:3PL.II
doKt_huutt	doKt	X;IN:ROOT;IN:PL;IN:3.II;OUT:ROOT;OUT:PL;OUT:3.II
jehl_doGot	jisjahlit	X;IN:ROOT;OUT:ROOT;OUT:PL;OUT:TR;OUT:3.II
hlguts'uusgi'm_gut'ihlxwi'y	guts'uusgi'y	X;IN:ROOT;IN:1PL.II;OUT:ROOT;OUT:1SG.II
hlimoodiit_sip	hlimoo	X;IN:ROOT;IN:3PL.II;OUT:ROOT
gidiiguu_limXs	gidiidoK	X;IN:ROOT;OUT:ROOT;OUT:PL
nigwoot_gidaXdiit	nigwootdiit	X;IN:ROOT;OUT:ROOT;OUT:3PL.II
wen_bekwdiit	wandiit	X;IN:ROOT;IN:PL;OUT:ROOT;OUT:PL;OUT:3PL.II
baXt_ga'a	baX	X;IN:ROOT;IN:3.II;OUT:ROOT
wilaayisi'm_t'is	halaa	X;IN:ROOT;IN:TR;IN:2PL.II;OUT:ROOT
loo_kw'esin	gyoo	X;IN:ROOT;IN:PL;OUT:ROOT
tXooK_guseeGat	gubit	X;IN:ROOT;IN:PL;OUT:ROOT;OUT:TR;OUT:3.II
hlimoo'lt_haxwdekwt	hlimoo'ltt	X;IN:ROOT;OUT:ROOT;OUT:3.II
yukw_sdint	yukwt	X;IN:ROOT;OUT:ROOT;OUT:3.II
hap_maa'y	tK'esxw	X;IN:ROOT;IN:PL;OUT:ROOT
Gant_t'ekw	pole	X;IN:ROOT;IN:3.II;OUT:ROOT
nekst_simgigat	niinixs	X;IN:ROOT;IN:3.II;OUT:ROOT;OUT:PL
gipaykwdiit_lem	gipaykw	X;IN:ROOT;IN:3PL.II;OUT:ROOT;OUT:PL
'yens_Gost	'yenst	X;IN:ROOT;OUT:ROOT;OUT:3.II
lidindiit_daha'wit	hidint	X;IN:ROOT;IN:PL;IN:3PL.II;OUT:ROOT;OUT:3.II
t'ehl_ixwt	maKt	X;IN:ROOT;IN:PL;OUT:ROOT;OUT:3.II
niye'et_toost	niye'e	X;IN:ROOT;IN:3.II;OUT:ROOT
kwsdins_tXalpXat	kwsdinsit	X;IN:ROOT;OUT:ROOT;OUT:SX
hlguts'uusgi'y_isi'm	guts'uusgi'm	X;IN:ROOT;IN:1SG.II;OUT:ROOT;OUT:1PL.II
'negwit_dewdew	'niiluxw	X;IN:ROOT;IN:SX;OUT:ROOT;OUT:PL
joGo'y_lekwdiit	joKdiit	X;IN:ROOT;IN:1SG.II;OUT:ROOT;OUT:3PL.II
laahldiit_'mootxw	giihl	X;IN:ROOT;IN:PL;IN:3PL.II;OUT:ROOT
giihl_gigi'ydiit	laahldiit	X;IN:ROOT;OUT:ROOT;OUT:PL;OUT:3PL.II
wani'm_gidiidoKdiit	wendiit	X;IN:ROOT;IN:PL;IN:1PL.II;OUT:ROOT;OUT:PL;OUT:3PL.II
jabi'y_didalGan	jebin	X;IN:ROOT;IN:TR;IN:1SG.II;OUT:ROOT;OUT:TR;OUT:2SG.II
gidaXa'm_ayukwst	gidaXt	X;IN:ROOT;IN:1PL.II;OUT:ROOT;OUT:3.II
daa'wihlt_wilt	daa'whlit	X;IN:ROOT;IN:3.II;OUT:ROOT;OUT:SX
hlguuhlxum_t'ilXoo'y	hlguuhlxwi'y	X;IN:ROOT;IN:ATTR;OUT:ROOT;OUT:1SG.II
la_lixleyit	lixleyit	X;IN:ROOT;OUT:ROOT;OUT:PL;OUT:SX
ma'us_gudets'i'y	ma'usi'y	X;IN:ROOT;OUT:ROOT;OUT:1SG.II
gett_yee'y	gedi'y	X;IN:ROOT;IN:3.II;OUT:ROOT;OUT:1SG.II
sinhunt_ga'a	sinhun	X;IN:ROOT;IN:3.II;OUT:ROOT
wili'm_Goodi'y	wili'y	X;IN:ROOT;IN:1PL.II;OUT:ROOT;OUT:1SG.II
jepdiit_'wayit	jabit	X;IN:ROOT;IN:3PL.II;OUT:ROOT;OUT:TR;OUT:3.II
salimxdiit_anooKdiit	silimxdiit	X;IN:ROOT;IN:3PL.II;OUT:ROOT;OUT:3PL.II
laXyibit_ts'axw	laXyip	X;IN:ROOT;IN:SX;OUT:ROOT
gi'yt_bitxw	gi'y	X;IN:ROOT;IN:3.II;OUT:ROOT
noX_office'y	noXa'y	X;IN:ROOT;OUT:ROOT;OUT:1SG.II
joKt_hlo'o'm	joGo'm	X;IN:ROOT;IN:3.II;OUT:ROOT;OUT:1PL.II
ts'ehlX_a'laXdiit	ts'ehlXdiit	X;IN:ROOT;OUT:ROOT;OUT:3PL.II
seksit_GanGan	seks	X;IN:ROOT;IN:PL;IN:SX;OUT:ROOT;OUT:PL
Gootdiit_doKt	GaGoott	X;IN:ROOT;IN:3PL.II;OUT:ROOT;OUT:PL;OUT:3.II
ga'at_Xa'naayi'm	ga'a'm	X;IN:ROOT;IN:TR;IN:3.II;OUT:ROOT;OUT:1PL.II
helda_siget	helt	X;IN:ROOT;IN:ATTR;OUT:ROOT
ga'a'm_anooGo'm	ga'a'm	X;IN:ROOT;IN:TR;IN:1PL.II;OUT:ROOT;OUT:1PL.II
miint_waa	miin	X;IN:ROOT;IN:3.II;OUT:ROOT
limXs_siwe	'mas	X;IN:ROOT;IN:PL;OUT:ROOT
went_hlo'ot	wanit	X;IN:ROOT;IN:PL;IN:3.II;OUT:ROOT;OUT:PL;OUT:SX
wendiit_gwilan	t'aan	X;IN:ROOT;IN:PL;IN:3PL.II;OUT:ROOT;OUT:2SG.II
sGa'wadiit_Ganaa'wt	sGa'wat	X;IN:ROOT;IN:3PL.II;OUT:ROOT;OUT:3.II
t'aat_uu'w	t'aa	X;IN:ROOT;IN:3.II;OUT:ROOT
baGadili'm_ama	baGadilim	X;IN:ROOT;IN:1PL.II;OUT:ROOT;OUT:ATTR
baGadilt_Gos	baGadil	X;IN:ROOT;IN:SX;OUT:ROOT
lidint_luuwendindiit	lidindiit	X;IN:ROOT;IN:PL;IN:3.II;OUT:ROOT;OUT:PL;OUT:3PL.II
joKdiit_nigwoodi'y	joGo'y	X;IN:ROOT;IN:3PL.II;OUT:ROOT;OUT:1SG.II
dildilsdiit_gi'namhlguuhlxw	dils	X;IN:ROOT;IN:PL;IN:3PL.II;OUT:ROOT
halaa_'wayit	wilaayit	X;IN:ROOT;OUT:ROOT;OUT:TR;OUT:3.II
Goldiit_Goli'm	Goli'm	X;IN:ROOT;IN:PL;IN:3PL.II;OUT:ROOT;OUT:PL;OUT:1PL.II
laXyip_gilbilt	laXyibit	X;IN:ROOT;OUT:ROOT;OUT:SX
ksimaasdiit_limx'oo'y	ksimaas	X;IN:ROOT;IN:3PL.II;OUT:ROOT
yeet_office'y	yee'y	X;IN:ROOT;IN:3.II;OUT:ROOT;OUT:1SG.II
gupt_tXalpX	gup	X;IN:ROOT;IN:3.II;OUT:ROOT
wilpt_gidiidoK	huwilp	X;IN:ROOT;IN:3.II;OUT:ROOT;OUT:PL
gwila_haky'o'ot	gwilat	X;IN:ROOT;OUT:ROOT;OUT:3.II
tXooK_t'amt	gupt	X;IN:ROOT;IN:PL;OUT:ROOT;OUT:3.II
ayawaatxwdiit_ayawaatxw	ayawaatxw	X;IN:ROOT;IN:3PL.II;OUT:ROOT
ga'a_wandiit	gitga'adiit	X;IN:ROOT;OUT:ROOT;OUT:PL;OUT:3PL.II
t'am_guxwin	t'amin	X;IN:ROOT;OUT:ROOT;OUT:TR;OUT:2SG.II
hlguts'uusgi'm_hugwaXt	hlguts'uusxt	X;IN:ROOT;IN:1PL.II;OUT:ROOT;OUT:3.II
hahla'ljit_desdiit	hahle'lsdiit	X;IN:ROOT;IN:SX;OUT:ROOT;OUT:3PL.II
gwila_ayooGa'm	gwila'm	X;IN:ROOT;OUT:ROOT;OUT:1PL.II
niye'e'y_daa'whlt	niye'et	X;IN:ROOT;IN:1SG.II;OUT:ROOT;OUT:3.II
bekwt_bahlXant	'witxwt	X;IN:ROOT;IN:PL;IN:3.II;OUT:ROOT;OUT:3.II
ts'uusxim_laya	ts'uusgim	X;IN:ROOT;IN:ATTR;OUT:ROOT;OUT:ATTR
joGo'm_hlo'ot	jaXjoGat	X;IN:ROOT;IN:1PL.II;OUT:ROOT;OUT:PL;OUT:SX
Galts'ebi'm_'niiluxw	Galjipts'ep	X;IN:ROOT;IN:1PL.II;OUT:ROOT;OUT:PL
halaaxdiit_gitxsdiit	wilaaxdiit	X;IN:ROOT;IN:3PL.II;OUT:ROOT;OUT:3PL.II
sGa'wat_ksibahandiit	sGa'wadiit	X;IN:ROOT;IN:3.II;OUT:ROOT;OUT:3PL.II
noXon_ga'a'y	noXa'y	X;IN:ROOT;IN:2SG.II;OUT:ROOT;OUT:1SG.II
laahldiit_laahli'm	laahli'm	X;IN:ROOT;IN:PL;IN:3PL.II;OUT:ROOT;OUT:PL;OUT:1PL.II
ayukwsim_baXyuxwdiithl	ayukwsdiit	X;IN:ROOT;IN:ATTR;OUT:ROOT;OUT:3PL.II
ayooKt_ayukwsi'm	ayooGa'm	X;IN:ROOT;IN:3.II;OUT:ROOT;OUT:1PL.II
wili'm_gwilat	wilt	X;IN:ROOT;IN:1PL.II;OUT:ROOT;OUT:3.II
hlgi'y_huutt	hlgit	X;IN:ROOT;IN:PL;IN:1SG.II;OUT:ROOT;OUT:PL;OUT:3.II
'nagwit_saks	'niiluxw	X;IN:ROOT;IN:SX;OUT:ROOT;OUT:PL
gwiladiit_t'aan	gwilan	X;IN:ROOT;IN:3PL.II;OUT:ROOT;OUT:2SG.II
dibakwdiit_lem	dibakw	X;IN:ROOT;IN:PL;IN:3PL.II;OUT:ROOT;OUT:PL
saGaytGootda_baasxdiit	saGaytGootdiit	X;IN:ROOT;IN:3PL;OUT:ROOT;OUT:3PL.II
Goodain_tXalpXu'm	Goodini'm	X;IN:ROOT;OUT:ROOT;OUT:1PL.II
'witxwit_dildilsdiit	bekwdiit	X;IN:ROOT;IN:SX;OUT:ROOT;OUT:PL;OUT:3PL.II
saksdiit_GasGoot	daa'whlit	X;IN:ROOT;IN:PL;IN:3PL.II;OUT:ROOT;OUT:SX
yuxw_'wayit	yuxwit	X;IN:ROOT;OUT:ROOT;OUT:TR;OUT:3.II
joKt_t'ipXaadit	joGot	X;IN:ROOT;IN:3.II;OUT:ROOT;OUT:SX
gitxsdiit_gwilain	gitxs	X;IN:ROOT;IN:3PL.II;OUT:ROOT
aliisxw_huudi'm	aliisxu'm	X;IN:ROOT;IN:PL;OUT:ROOT;OUT:PL;OUT:1PL.II
gupt_limx'oo'y	yooK	X;IN:ROOT;IN:3.II;OUT:ROOT
halaaxdiit_yuwi'y	wilaayi'y	X;IN:ROOT;IN:3PL.II;OUT:ROOT;OUT:TR;OUT:1SG.II
yukw_gi'namdiit	yukwdiit	X;IN:ROOT;OUT:ROOT;OUT:3PL.II
Goott_wilplaahlt	GaGoott	X;IN:ROOT;IN:3.II;OUT:ROOT;OUT:PL;OUT:3.II
'masi'y_gudets'i'y	'mesi'y	X;IN:ROOT;IN:1SG.II;OUT:ROOT;OUT:1SG.II
hlguts'uus_gwila'm	hlguts'uusgi'm	X;IN:ROOT;OUT:ROOT;OUT:1PL.II
'wiiyitxwt_ts'ak'	wiyitxw	X;IN:ROOT;IN:3.II;OUT:ROOT
seks_hlo'ot	seksit	X;IN:ROOT;IN:PL;OUT:ROOT;OUT:PL;OUT:SX
jebin_nigwootdiit	jepdiit	X;IN:ROOT;IN:TR;IN:2SG.II;OUT:ROOT;OUT:3PL.II
hasaKdiit_hasaKsi'm	hasaKsi'm	X;IN:ROOT;IN:3PL.II;OUT:ROOT;OUT:2PL.II
wen_bekw	wan	X;IN:ROOT;IN:PL;OUT:ROOT;OUT:PL
aliisxw_nigwoodi'm	alisxu'm	X;IN:ROOT;IN:PL;OUT:ROOT;OUT:1PL.II
hal'algaXt_luut'ipdaa'wt	algaXt	X;IN:ROOT;IN:PL;IN:3.II;OUT:ROOT;OUT:3.II
gigitxsit_ky'ul	gitxs	X;IN:ROOT;IN:PL;IN:SX;OUT:ROOT
want_sisipt	want	X;IN:ROOT;IN:PL;IN:SX;OUT:ROOT;OUT:PL;OUT:3.II
jaXjoGo'm_hithit't	jaXjoKt	X;IN:ROOT;IN:PL;IN:1PL.II;OUT:ROOT;OUT:PL;OUT:3.II
t'amin_gwilat	t'amt	X;IN:ROOT;IN:TR;IN:2SG.II;OUT:ROOT;OUT:3.II
baasxi'y_naX'nidiit	baasxdiit	X;IN:ROOT;IN:TR;IN:1SG.II;OUT:ROOT;OUT:3PL.II
daXgadim_hiji'm	daXgedi'm	X;IN:ROOT;IN:ATTR;OUT:ROOT;OUT:1PL.II
xsaxw_niye'et	xsaxwt	X;IN:ROOT;OUT:ROOT;OUT:3.II
hlo'o'm_luut'ehldiit	hlo'odiit	X;IN:ROOT;IN:PL;IN:1PL.II;OUT:ROOT;OUT:PL;OUT:3PL.II
t'aa_t'ipXaadit	t'aat	X;IN:ROOT;OUT:ROOT;OUT:SX
Xsdaadiit_niye'et	Xsdaat	X;IN:ROOT;IN:3PL.II;OUT:ROOT;OUT:3.II
kw'asint_gin	kw'esin	X;IN:ROOT;IN:3.II;OUT:ROOT
saalukwdiit_ga'adiit	saalukwdiit	X;IN:ROOT;IN:3PL.II;OUT:ROOT;OUT:3PL.II
a'laXdiit_'maXst	a'laXt	X;IN:ROOT;IN:3PL.II;OUT:ROOT;OUT:3.II
he_Galts'ept	het	X;IN:ROOT;OUT:ROOT;OUT:3.II
doKt_doXdiit	doKdiit	X;IN:ROOT;IN:PL;IN:3.II;OUT:ROOT;OUT:PL;OUT:3PL.II
halaaxdiit_wilaayisi'm	wilaayisi'm	X;IN:ROOT;IN:3PL.II;OUT:ROOT;OUT:TR;OUT:2PL.II
jebin_an'ixwt	jept	X;IN:ROOT;IN:TR;IN:2SG.II;OUT:ROOT;OUT:3.II
daa'whldiit_gidiidoKdiit	saksdiit	X;IN:ROOT;IN:3PL.II;OUT:ROOT;OUT:PL;OUT:3PL.II
seksit_gitxsdiit	daa'whldiit	X;IN:ROOT;IN:PL;IN:SX;OUT:ROOT;OUT:3PL.II
ga'a_tK'alyeet	ga'at	X;IN:ROOT;OUT:ROOT;OUT:3.II
yuxw_liluxwsdiit	yuxwdiit	X;IN:ROOT;OUT:ROOT;OUT:3PL.II
hahla'lsdi'm_t'aa	hahle'lst	X;IN:ROOT;IN:1PL.II;OUT:ROOT
GedaXdiit_Galts'epdiit	gidaXdiit	X;IN:ROOT;IN:3PL.II;OUT:ROOT;OUT:3PL.II
joGot_hal'olaXat	jaXjoGot	X;IN:ROOT;IN:SX;OUT:ROOT;OUT:PL;OUT:SX
wiyitxwt_heltdiit	wiyitxwdiit	X;IN:ROOT;IN:3.II;OUT:ROOT;OUT:3PL.II
wat_jem	we	X;IN:ROOT;IN:3.II;OUT:ROOT
gitxs_midint	gitxt	X;IN:ROOT;OUT:ROOT;OUT:3.II
maKt_saGaytwendiit	t'ehldiit	X;IN:ROOT;IN:3.II;OUT:ROOT;OUT:PL;OUT:3PL.II
jept_hlo'odiit	jipjepdiit	X;IN:ROOT;IN:3.II;OUT:ROOT;OUT:PL;OUT:3PL.II
'mas_nibibi'y	'mesi'y	X;IN:ROOT;OUT:ROOT;OUT:1SG.II
daXgadim_hlimoo'm	daXgedi'm	X;IN:ROOT;IN:ATTR;OUT:ROOT;OUT:1PL.II
bant_naX'nit	bent	X;IN:ROOT;IN:3.II;OUT:ROOT;OUT:3.II
went_al'alGaldiit	wandiit	X;IN:ROOT;IN:PL;IN:3.II;OUT:ROOT;OUT:PL;OUT:3PL.II
gipaygum_dibekwt	gipaykwt	X;IN:ROOT;IN:ATTR;OUT:ROOT;OUT:PL;OUT:3.II
seks_'weesxwt	daa'whlt	X;IN:ROOT;IN:PL;OUT:ROOT;OUT:3.II
'mast_t'isim	'mesim	X;IN:ROOT;IN:3.II;OUT:ROOT;OUT:ATTR
t'agi'y_neet	t'ekt	X;IN:ROOT;IN:1SG.II;OUT:ROOT;OUT:3.II
GaGoott_ga'a'm	Goodi'm	X;IN:ROOT;IN:PL;IN:3.II;OUT:ROOT;OUT:1PL.II
t'is_hlguuhlxum	t'isim	X;IN:ROOT;OUT:ROOT;OUT:ATTR
t'ehldiit_ts'o'oXs	maK	X;IN:ROOT;IN:PL;IN:3PL.II;OUT:ROOT
xwdaxt_luxdaxdiit	luxdaxdiit	X;IN:ROOT;IN:3.II;OUT:PL;OUT:ROOT;OUT:3PL.II
ts'in_'masi'y	ts'ini'y	X;IN:ROOT;OUT:ROOT;OUT:1SG.II
dibakw_doGot	dibegwit	X;IN:ROOT;IN:PL;OUT:ROOT;OUT:PL;OUT:TR;OUT:3.II
hlo'o'm_dawt	yeet	X;IN:ROOT;IN:PL;IN:1PL.II;OUT:ROOT;OUT:3.II
a'laX_Ganaa'wt	a'laXt	X;IN:ROOT;OUT:ROOT;OUT:3.II
sdili'm_ayawaatxwdiit	sdildiit	X;IN:ROOT;IN:1PL.II;OUT:ROOT;OUT:3PL.II
jaXjoGat_wani'm	jaXjoGo'm	X;IN:ROOT;IN:PL;IN:SX;OUT:ROOT;OUT:PL;OUT:1PL.II
ma'us_huut	mihas'us	X;IN:ROOT;OUT:ROOT;OUT:PL
Goodi'm_gupdiit	Gootdiit	X;IN:ROOT;IN:1PL.II;OUT:ROOT;OUT:3PL.II
hlgi'y_ha'niiwilXsdiit	hlgidiit	X;IN:ROOT;IN:PL;IN:1SG.II;OUT:ROOT;OUT:PL;OUT:3PL.II
t'aa_hen	t'aan	X;IN:ROOT;OUT:ROOT;OUT:2SG.II
simgigat_saks	simgiget	X;IN:ROOT;IN:PL;OUT:ROOT;OUT:PL
ama_ts'ee	am	X;IN:ROOT;IN:ATTR;OUT:ROOT
nibibi'y_yee'm	nibibi'm	X;IN:ROOT;IN:1SG.II;OUT:ROOT;OUT:1PL.II
noXa'y_joGo'y	noho'y	X;IN:ROOT;IN:1SG.II;OUT:ROOT;OUT:1SG.II
baGadilda_maGoon	baGadil	X;IN:ROOT;IN:3PL;OUT:ROOT
gipaykw_GaGoott	gipaykwt	X;IN:ROOT;OUT:ROOT;OUT:PL;OUT:3.II
hahle'lsit_hahla'lsdi'm	hahle'lsdi'm	X;IN:ROOT;IN:SX;OUT:ROOT;OUT:1PL.II
baXt_mas'usi'm	Goli'm	X;IN:ROOT;IN:3.II;OUT:ROOT;OUT:PL;OUT:1PL.II
yee'y_iwit	yeet	X;IN:ROOT;IN:1SG.II;OUT:ROOT;OUT:SX
sekst_ha'niiwan	seks	X;IN:ROOT;IN:PL;IN:3.II;OUT:ROOT;OUT:PL
ky'uldiit_amks	ky'ul	X;IN:ROOT;IN:3PL.II;OUT:ROOT
doKdiit_Gest	guut	X;IN:ROOT;IN:PL;IN:3PL.II;OUT:ROOT;OUT:3.II
noXo'y_a'laXa'm	noXo'm	X;IN:ROOT;IN:1SG.II;OUT:ROOT;OUT:1PL.II
joKt_da'aKhlxwi'y	joGo'y	X;IN:ROOT;IN:3.II;OUT:ROOT;OUT:1SG.II
wanit_mis'usi'm	weni'm	X;IN:ROOT;IN:PL;IN:SX;OUT:ROOT;OUT:PL;OUT:1PL.II
maKt_'nu'wdiit	maKdiit	X;IN:ROOT;IN:3.II;OUT:ROOT;OUT:3PL.II
Gol_hishalaagaXdiit	Goldiit	X;IN:ROOT;IN:PL;OUT:ROOT;OUT:PL;OUT:3PL.II
daa'whlt_al'alGaldiit	saksdiit	X;IN:ROOT;IN:3.II;OUT:ROOT;OUT:PL;OUT:3PL.II
huwilaa_yuwit	wilaayit	X;IN:ROOT;IN:PL;OUT:ROOT;OUT:TR;OUT:3.II
wilaaxdiit_saGaytGootdiit	halaaxdiit	X;IN:ROOT;IN:3PL.II;OUT:ROOT;OUT:3PL.II
ga'a'y_GatGoodindiit	gitga'adiit	X;IN:ROOT;IN:1SG.II;OUT:ROOT;OUT:PL;OUT:3PL.II
hlguts'uusgi'm_aX'algaGa'y	guts'uusgi'y	X;IN:ROOT;IN:1PL.II;OUT:ROOT;OUT:1SG.II
daXgat_xwdaxt	daXgett	X;IN:ROOT;OUT:ROOT;OUT:3.II
hlo'ot_gwiiseeKt	hlo'ot	X;IN:ROOT;IN:PL;IN:SX;OUT:ROOT;OUT:PL;OUT:3.II
Gabiit_Gootdiit	Gabidiit	X;IN:ROOT;IN:SX;OUT:ROOT;OUT:3PL.II
hahla'ljit_he'm	hahla'lsdi'm	X;IN:ROOT;IN:SX;OUT:ROOT;OUT:1PL.II
saGaytGootda_gi'namhlguuhlxw	saGaytGoot	X;IN:ROOT;IN:3PL;OUT:ROOT
joKt_ment	joGat	X;IN:ROOT;IN:3.II;OUT:ROOT;OUT:SX
hapdiit_ansdo'ot	hapt	X;IN:ROOT;IN:3PL.II;OUT:ROOT;OUT:3.II
yeet_ts'ept	yeet	X;IN:ROOT;IN:3.II;OUT:ROOT;OUT:3.II
hlgim_luuwent	hlgit	X;IN:ROOT;IN:PL;IN:ATTR;OUT:ROOT;OUT:PL;OUT:3.II
joGo'y_wilt	joGot	X;IN:ROOT;IN:1SG.II;OUT:ROOT;OUT:SX
joGat_Xa'naayi'm	joGo'm	X;IN:ROOT;IN:SX;OUT:ROOT;OUT:1PL.II
yee_mas'usi'm	hlo'o'm	X;IN:ROOT;OUT:ROOT;OUT:PL;OUT:1PL.II
sekst_sinhunt	daa'whlit	X;IN:ROOT;IN:PL;IN:3.II;OUT:ROOT;OUT:SX
gipaykwt_huwilaa	gipaykw	X;IN:ROOT;IN:3.II;OUT:ROOT;OUT:PL
wiyitsxwdiit_yimt	'wiiyitxwt	X;IN:ROOT;IN:3PL.II;OUT:ROOT;OUT:3.II
sGa'wadiit_'mast	sGa'wat	X;IN:ROOT;IN:3PL.II;OUT:ROOT;OUT:3.II
wilaaxdiit_baasxi'y	wilaayi'y	X;IN:ROOT;IN:3PL.II;OUT:ROOT;OUT:TR;OUT:1SG.II
anooKt_a'laXdiit	anooKdiit	X;IN:ROOT;IN:3.II;OUT:ROOT;OUT:3PL.II
hlguts'uusxt_joGo'y	guts'uusgi'y	X;IN:ROOT;IN:3.II;OUT:ROOT;OUT:1SG.II
t'aat_dexwdiit	wendiit	X;IN:ROOT;IN:SX;OUT:ROOT;OUT:PL;OUT:3PL.II
ayukwst_siwe	ayukws	X;IN:ROOT;IN:3.II;OUT:ROOT
wilaayisi'm_hit'int	wilaayit	X;IN:ROOT;IN:TR;IN:2PL.II;OUT:ROOT;OUT:TR;OUT:3.II
limixi'm_sgit	limxt	X;IN:ROOT;IN:1PL.II;OUT:ROOT;OUT:3.II
lixsgat_andabim	liksgedim	X;IN:ROOT;OUT:ROOT;OUT:ATTR
wilaayisi'm_dit'e'ldiit	wilaaxdiit	X;IN:ROOT;IN:TR;IN:2PL.II;OUT:ROOT;OUT:3PL.II
huwilp_hap	wilp	X;IN:ROOT;IN:PL;OUT:ROOT
ksi'wadiit_desdiit	ksi'wadiit	X;IN:ROOT;IN:3PL.II;OUT:ROOT;OUT:3PL.II
sgit_am'amt	doXt	X;IN:ROOT;IN:3.II;OUT:ROOT;OUT:PL;OUT:3.II
saksit_Gabidiit	daa'whldiit	X;IN:ROOT;IN:PL;IN:SX;OUT:ROOT;OUT:3PL.II
hooyi'm_guseeGat	hooyit	X;IN:ROOT;IN:TR;IN:1PL.II;OUT:ROOT;OUT:TR;OUT:3.II
wendiit_dohot	went	X;IN:ROOT;IN:PL;IN:3PL.II;OUT:ROOT;OUT:PL;OUT:SX
(K'amksiwaamX)_'wadiit	K'amksiwaamXdiit	X;IN:ROOT;OUT:ROOT;OUT:3PL.II
wilaaxt_wilaayisi'm	wilaayisi'm	X;IN:ROOT;IN:3.II;OUT:ROOT;OUT:TR;OUT:2PL.II
want_gipaygum	t'aam	X;IN:ROOT;IN:PL;IN:3.II;OUT:ROOT;OUT:ATTR
t'agi'y_K'ay'mesi'y	t'agi'y	X;IN:ROOT;IN:TR;IN:1SG.II;OUT:ROOT;OUT:1SG.II
hahla'ljit_gi'namdiit	hahle'lstdiit	X;IN:ROOT;IN:SX;OUT:ROOT;OUT:3PL.II
GaGootdiit_sGat'akwt	Goott	X;IN:ROOT;IN:PL;IN:3PL.II;OUT:ROOT;OUT:3.II
saGaytwendiit_saGaytwenda	saGaytwenda	X;IN:ROOT;IN:PL;IN:3PL.II;OUT:ROOT;OUT:PL;OUT:3PL
ma'usi'y_sise'en	mihas'usin	X;IN:ROOT;IN:1SG.II;OUT:ROOT;OUT:PL;OUT:2SG.II
win_baXt	wilt	X;IN:ROOT;IN:2SG.II;OUT:ROOT;OUT:3.II
hlguts'uusgi'y_Galts'ebi'm	guts'uusgi'm	X;IN:ROOT;IN:1SG.II;OUT:ROOT;OUT:1PL.II
noXo'y_meeX	noX	X;IN:ROOT;IN:1SG.II;OUT:ROOT
a'laXt_gwilan	a'laXan	X;IN:ROOT;IN:3.II;OUT:ROOT;OUT:2SG.II
loot_t'ahl	loo	X;IN:ROOT;IN:PL;IN:3.II;OUT:ROOT;OUT:PL
daa'wihlt_saksit	saksit	X;IN:ROOT;IN:3.II;OUT:ROOT;OUT:PL;OUT:SX
guseeK_Gant	guseeKt	X;IN:ROOT;OUT:ROOT;OUT:3.II
guu_sise'ediit	doKdiit	X;IN:ROOT;OUT:ROOT;OUT:PL;OUT:3PL.II
heet_Goodi'm	he'm	X;IN:ROOT;IN:SX;OUT:ROOT;OUT:1PL.II
seksit_huutt	sekst	X;IN:ROOT;IN:PL;IN:SX;OUT:ROOT;OUT:PL;OUT:3.II
sdildiit_alisxu'm	sdili'm	X;IN:ROOT;IN:3PL.II;OUT:ROOT;OUT:1PL.II
ts'uusgi'y_daGo'odim	ts'uusxim	X;IN:ROOT;IN:1SG.II;OUT:ROOT;OUT:ATTR
'nu'wdiit_tXooK	dexw	X;IN:ROOT;IN:3PL.II;OUT:ROOT;OUT:PL
jaXjoKdiit_Galts'ebi'm	joGo'm	X;IN:ROOT;IN:PL;IN:3PL.II;OUT:ROOT;OUT:1PL.II
gupt_aluugiget	tXooK	X;IN:ROOT;IN:3.II;OUT:ROOT;OUT:PL
saks_laahldiit	saksdiit	X;IN:ROOT;IN:PL;OUT:ROOT;OUT:PL;OUT:3PL.II
hlguuhlxw_am'ama	hlgim	X;IN:ROOT;OUT:ROOT;OUT:PL;OUT:ATTR
wilp_dexwt	huwilpt	X;IN:ROOT;OUT:ROOT;OUT:PL;OUT:3.II
wilaayi'y_gi'namit	wilaayit	X;IN:ROOT;IN:TR;IN:1SG.II;OUT:ROOT;OUT:TR;OUT:3.II
jaXjoGo'm_didi'ydiit	joKdiit	X;IN:ROOT;IN:PL;IN:1PL.II;OUT:ROOT;OUT:3PL.II
saks_luuwendindiit	seksdiit	X;IN:ROOT;IN:PL;OUT:ROOT;OUT:PL;OUT:3PL.II
we'y_ky'ult	wat	X;IN:ROOT;IN:1SG.II;OUT:ROOT;OUT:SX
didilsdi'm_dexwit	dildilsit	X;IN:ROOT;IN:PL;IN:1PL.II;OUT:ROOT;OUT:PL;OUT:SX
daa'whlt_dewdew	seks	X;IN:ROOT;IN:3.II;OUT:ROOT;OUT:PL
maKdiit_yee	maK	X;IN:ROOT;IN:3PL.II;OUT:ROOT
'mesi'y_am'ama	limXsim	X;IN:ROOT;IN:1SG.II;OUT:ROOT;OUT:PL;OUT:ATTR
saksdiit_t'imGest	daa'wihlt	X;IN:ROOT;IN:PL;IN:3PL.II;OUT:ROOT;OUT:3.II
hlgidiit_hlgim	hlgim	X;IN:ROOT;IN:PL;IN:3PL.II;OUT:ROOT;OUT:PL;OUT:ATTR
sityeexw_hit'int	sityeewit	X;IN:ROOT;OUT:ROOT;OUT:TR;OUT:3.II
'witxwi'y_hisyetst	bekwt	X;IN:ROOT;IN:1SG.II;OUT:ROOT;OUT:PL;OUT:3.II
nekst_he	neks	X;IN:ROOT;IN:3.II;OUT:ROOT
daa'wihlt_sdilt	daa'whlt	X;IN:ROOT;IN:3.II;OUT:ROOT;OUT:3.II
huks_huksi'y	huksi'y	X;IN:ROOT;OUT:ROOT;OUT:1SG.II
tK'esxw_gubit	tK'esxwit	X;IN:ROOT;OUT:ROOT;OUT:TR;OUT:3.II
gyoo_hlk'uba	loo	X;IN:ROOT;OUT:ROOT;OUT:PL
t'aat_wani'm	weni'm	X;IN:ROOT;IN:3.II;OUT:ROOT;OUT:PL;OUT:1PL.II
saGaytwendiit_saGaytwenda	saGaytwenda	X;IN:ROOT;IN:PL;IN:3PL.II;OUT:ROOT;OUT:PL;OUT:3PL
t'aa_saXdoXdiit	wendiit	X;IN:ROOT;OUT:ROOT;OUT:PL;OUT:3PL.II
iksde_agut	iksdet	X;IN:ROOT;OUT:ROOT;OUT:3.II
hilendiit_ha'niiGootdiit	iilendiit	X;IN:ROOT;IN:3PL.II;OUT:ROOT;OUT:3PL.II
bagu'm_tXooGant	bekwt	X;IN:ROOT;IN:PL;IN:1PL.II;OUT:ROOT;OUT:PL;OUT:3.II
wisi'm_hlis	wil	X;IN:ROOT;IN:2PL.II;OUT:ROOT
daXgedi'm_gehlim	daXgadim	X;IN:ROOT;IN:1PL.II;OUT:ROOT;OUT:ATTR
Goodin_da'aKhlxwi'y	Goodi'y	X;IN:ROOT;IN:2SG.II;OUT:ROOT;OUT:1SG.II
woowaXa'm_dit'aX	woowaX	X;IN:ROOT;IN:PL;IN:1PL.II;OUT:ROOT;OUT:PL
hahla'lsdi'm_'witxwi'y	hahla'lsdi'y	X;IN:ROOT;IN:1PL.II;OUT:ROOT;OUT:1SG.II
xseeK_we'y	xsawi'y	X;IN:ROOT;IN:PL;OUT:ROOT;OUT:1SG.II
jaXjoKt_yukwsindiit	joKdiit	X;IN:ROOT;IN:PL;IN:3.II;OUT:ROOT;OUT:3PL.II
Goodi'm_gwiiladiit	GaGootdiit	X;IN:ROOT;IN:1PL.II;OUT:ROOT;OUT:PL;OUT:3PL.II
hloXst_ayukwsim	hloXsa	X;IN:ROOT;IN:3.II;OUT:ROOT;OUT:ATTR
maKdiit_saks	t'ahl	X;IN:ROOT;IN:3PL.II;OUT:ROOT;OUT:PL
ha'wi'm_gakst	ha'wit	X;IN:ROOT;IN:1PL.II;OUT:ROOT;OUT:3.II
saGaytGoodindiit_alisxw	saGaytGoodain	X;IN:ROOT;IN:3PL.II;OUT:ROOT
jaXjoGot_ant'aahl	joK	X;IN:ROOT;IN:PL;IN:SX;OUT:ROOT
ayukwst_hahla'lsdi'm	ayukwsi'm	X;IN:ROOT;IN:3.II;OUT:ROOT;OUT:1PL.II
wandiit_dewdew	wan	X;IN:ROOT;IN:PL;IN:3PL.II;OUT:ROOT;OUT:PL
K'otsdiit_laya	K'ojam	X;IN:ROOT;IN:3PL.II;OUT:ROOT;OUT:ATTR
went_t'aat	t'aat	X;IN:ROOT;IN:PL;IN:SX;OUT:ROOT;OUT:SX
xwdaxt_gwila'm	Xdeyi'm	X;IN:ROOT;IN:3.II;OUT:ROOT;OUT:1PL.II
jebi'y_sityeexw	jep	X;IN:ROOT;IN:TR;IN:1SG.II;OUT:ROOT
neks_sGat'aat	nakst	X;IN:ROOT;OUT:ROOT;OUT:3.II
t'aan_meeXt	t'aat	X;IN:ROOT;IN:2SG.II;OUT:ROOT;OUT:3.II
t'agi'y_gigiinuxw	t'e	X;IN:ROOT;IN:1SG.II;OUT:ROOT
Gol_mail'y	baXa'y	X;IN:ROOT;IN:PL;OUT:ROOT;OUT:1SG.II
daa'whlit_gigitxsit	saksit	X;IN:ROOT;IN:SX;OUT:ROOT;OUT:PL;OUT:SX
ga'adiit_Xa'nii'y	ga'a'y	X;IN:ROOT;IN:3PL.II;OUT:ROOT;OUT:TR;OUT:1SG.II
welixt_hlgim	huwelixim	X;IN:ROOT;IN:3.II;OUT:ROOT;OUT:PL;OUT:ATTR
jaXjoGot_k'idaa'wt	joKt	X;IN:ROOT;IN:PL;IN:SX;OUT:ROOT;OUT:3.II
simgigat_huwilaa	simgigat	X;IN:ROOT;IN:PL;OUT:ROOT;OUT:PL
daa'wihlt_'wiidaX	seks	X;IN:ROOT;IN:3.II;OUT:ROOT;OUT:PL
dexwit_kwsdinsit	'nu'wt	X;IN:ROOT;IN:PL;IN:SX;OUT:ROOT;OUT:SX
went_haXhaaK'ant	went	X;IN:ROOT;IN:PL;IN:SX;OUT:ROOT;OUT:PL;OUT:3.II
am'amt_hit	am	X;IN:ROOT;IN:PL;IN:3.II;OUT:ROOT
ga'a'm_mo'on	ga'a	X;IN:ROOT;IN:TR;IN:1PL.II;OUT:ROOT
gimxdi_Go'odiit	gimxdiidiit	X;IN:ROOT;OUT:ROOT;OUT:3PL.II
saGaytGootdiit_heltda	saGaytGootda	X;IN:ROOT;IN:3PL.II;OUT:ROOT;OUT:3PL
am_jaXjoKt	am'amt	X;IN:ROOT;OUT:ROOT;OUT:PL;OUT:3.II
wilda_wildiit	wildiit	X;IN:ROOT;IN:3PL;OUT:ROOT;OUT:3PL.II
saGaytGoodain_hlibuut	saGaytGoodint	X;IN:ROOT;OUT:ROOT;OUT:3.II
yuxwt_siget	yuxw	X;IN:ROOT;IN:3.II;OUT:ROOT
hen_daa'whlt	het	X;IN:ROOT;IN:2SG.II;OUT:ROOT;OUT:3.II
doXt_'wadiit	sgidiit	X;IN:ROOT;IN:PL;IN:3.II;OUT:ROOT;OUT:3PL.II
wisi'm_t'ipXaadit	wilt	X;IN:ROOT;IN:2PL.II;OUT:ROOT;OUT:SX
t'aa_hlo'o'm	weni'm	X;IN:ROOT;OUT:ROOT;OUT:PL;OUT:1PL.II
we_hanaK't	wet	X;IN:ROOT;OUT:ROOT;OUT:3.II
gwila_huksin	gwilan	X;IN:ROOT;OUT:ROOT;OUT:2SG.II
loKt_daGo'odim	loGa	X;IN:ROOT;IN:3.II;OUT:ROOT;OUT:ATTR
doGo'm_GaGoott	doKt	X;IN:ROOT;IN:PL;IN:TR;IN:1PL.II;OUT:ROOT;OUT:PL;OUT:3.II
anooK_gidaXa'm	anooGo'm	X;IN:ROOT;OUT:ROOT;OUT:1PL.II
gett_ii'wxwt	ii'wxwt	X;IN:ROOT;IN:3.II;OUT:ROOT;OUT:PL
wandiit_tXooK	wen	X;IN:ROOT;IN:PL;IN:3PL.II;OUT:ROOT;OUT:PL
giihl_hlguuhlxwi'y	giihli'y	X;IN:ROOT;OUT:ROOT;OUT:1SG.II
t'ilXoo'y_noho'y	t'ilXoo'y	X;IN:ROOT;IN:1SG.II;OUT:ROOT;OUT:1SG.II
nakst_'wiidaX	niinixs	X;IN:ROOT;IN:3.II;OUT:ROOT;OUT:PL
daXgadim_'mits'in	daXgat	X;IN:ROOT;IN:ATTR;OUT:ROOT
bagu'm_GanGan	bekw	X;IN:ROOT;IN:PL;IN:1PL.II;OUT:ROOT;OUT:PL
went_XsdemGam	t'aam	X;IN:ROOT;IN:PL;IN:3.II;OUT:ROOT;OUT:ATTR
hahle'lstdiit_wa	hahle'lst	X;IN:ROOT;IN:3PL.II;OUT:ROOT
hogaX_gyuksint	hogaXat	X;IN:ROOT;OUT:ROOT;OUT:TR;OUT:3.II
yee'm_ts'int	yeet	X;IN:ROOT;IN:1PL.II;OUT:ROOT;OUT:3.II
saahlo'odiit_liiluxwdiit	saahlo'odiit	X;IN:ROOT;IN:PL;IN:3PL.II;OUT:ROOT;OUT:PL;OUT:3PL.II
wakt_hlguuhlxwi'y	wegi'y	X;IN:ROOT;IN:3.II;OUT:ROOT;OUT:1SG.II
gi'nami'y_hlimoo	gi'nam	X;IN:ROOT;IN:TR;IN:1SG.II;OUT:ROOT
gipaykwt_laX'nidiit	gipaykwdiit	X;IN:ROOT;IN:PL;IN:3.II;OUT:ROOT;OUT:3PL.II
woK'diit_bahlXant	woK't	X;IN:ROOT;IN:3PL.II;OUT:ROOT;OUT:3.II
desdiit_dekhl	das	X;IN:ROOT;IN:3PL.II;OUT:ROOT
t'ilXo'odiit_lekwdiit	t'ilXo'odiit	X;IN:ROOT;IN:3PL.II;OUT:ROOT;OUT:3PL.II
t'aat_ment	t'aat	X;IN:ROOT;IN:SX;OUT:ROOT;OUT:SX
'negwit_Ges	'nakw	X;IN:ROOT;IN:SX;OUT:ROOT
t'aat_doXt	went	X;IN:ROOT;IN:SX;OUT:ROOT;OUT:PL;OUT:3.II
hlimooyi'm_heltt	hlimoot	X;IN:ROOT;IN:TR;IN:1PL.II;OUT:ROOT;OUT:3.II
gubit_ga'a'm	gubi'm	X;IN:ROOT;IN:TR;IN:3.II;OUT:ROOT;OUT:TR;OUT:1PL.II
sityeewit_wadiit	sityeexwdiit	X;IN:ROOT;IN:TR;IN:3.II;OUT:ROOT;OUT:3PL.II
liluxwst_ts'eehl	liluxws	X;IN:ROOT;IN:3.II;OUT:ROOT
saGaytGootdiit_joKdiit	saGaytGootdiit	X;IN:ROOT;IN:3PL.II;OUT:ROOT;OUT:3PL.II
dildilsit_didilsdi'm	didilsdi'm	X;IN:ROOT;IN:PL;IN:SX;OUT:ROOT;OUT:PL;OUT:1PL.II
Galjipts'ep_niye'e'y	Galts'ebi'y	X;IN:ROOT;IN:PL;OUT:ROOT;OUT:1SG.II
jepdiit_ayukwst	jept	X;IN:ROOT;IN:3PL.II;OUT:ROOT;OUT:3.II
gitga'adiit_hiji'm	ga'a'm	X;IN:ROOT;IN:PL;IN:3PL.II;OUT:ROOT;OUT:1PL.II
daXgedi'm_daGo'odim	daXgadim	X;IN:ROOT;IN:1PL.II;OUT:ROOT;OUT:ATTR
wil'naat'ahldiit_didelKt	wil'naat'ehlt	X;IN:ROOT;IN:3PL.II;OUT:ROOT;OUT:3.II
hooxt_mahldiit	hooxdiit	X;IN:ROOT;IN:3.II;OUT:ROOT;OUT:3PL.II
we_salimxdiit	wadiit	X;IN:ROOT;OUT:ROOT;OUT:3PL.II
diyeediit_sbaaKhlxw	diyee	X;IN:ROOT;IN:3PL.II;OUT:ROOT
loKt_baGadilim	loGom	X;IN:ROOT;IN:3.II;OUT:ROOT;OUT:ATTR
wil'naat'ehl_yetst	wil'naat'ahlt	X;IN:ROOT;OUT:ROOT;OUT:3.II
Goodi'y_gyoot	Goott	X;IN:ROOT;IN:1SG.II;OUT:ROOT;OUT:3.II
wilaayi'y_an'aats'ipt	halaaxt	X;IN:ROOT;IN:TR;IN:1SG.II;OUT:ROOT;OUT:3.II
hahle'lsdi'm_algaX	hahle'lst	X;IN:ROOT;IN:1PL.II;OUT:ROOT
jebin_sGa'wa	jep	X;IN:ROOT;IN:TR;IN:2SG.II;OUT:ROOT
iilendiit_ayukws	hilen	X;IN:ROOT;IN:3PL.II;OUT:ROOT
hlguuhlxum_hlgim	hlgim	X;IN:ROOT;IN:ATTR;OUT:ROOT;OUT:PL;OUT:ATTR
'witxwit_laahl	bakw	X;IN:ROOT;IN:SX;OUT:ROOT;OUT:PL
hasaGa'm_'nagwit	hasaGat	X;IN:ROOT;IN:1PL.II;OUT:ROOT;OUT:SX
daha'wt_mahl	diha'w	X;IN:ROOT;IN:3.II;OUT:ROOT
hahla'ljit_xsa'aKxw	hahle'lst	X;IN:ROOT;IN:SX;OUT:ROOT
ga'a_gimxdiidiit	ga'adiit	X;IN:ROOT;OUT:ROOT;OUT:3PL.II
yuxwt_da'witxwit	yuwit	X;IN:ROOT;IN:3.II;OUT:ROOT;OUT:TR;OUT:3.II
t'ilXo'odiit_ts'uusgi'y	t'ilXoo'y	X;IN:ROOT;IN:3PL.II;OUT:ROOT;OUT:1SG.II
hlgit_ama	hlguuhlxum	X;IN:ROOT;IN:PL;IN:3.II;OUT:ROOT;OUT:ATTR
jep_da'witxwit	jabit	X;IN:ROOT;OUT:ROOT;OUT:TR;OUT:3.II
iksde_gigeenixt	ixsdat	X;IN:ROOT;OUT:ROOT;OUT:3.II
ky'ul_ts'int	ky'ult	X;IN:ROOT;OUT:ROOT;OUT:3.II
guu_miint	guut	X;IN:ROOT;OUT:ROOT;OUT:3.II
baKt_ts'iigwini'm	baGa'm	X;IN:ROOT;IN:3.II;OUT:ROOT;OUT:TR;OUT:1PL.II
da'aKhlxwdiit_hanaK'a'y	da'aKhlxwi'y	X;IN:ROOT;IN:3PL.II;OUT:ROOT;OUT:1SG.II
doKt_doGot	doGot	X;IN:ROOT;IN:PL;IN:3.II;OUT:ROOT;OUT:PL;OUT:TR;OUT:3.II
bakw_bekwt	bekwt	X;IN:ROOT;IN:PL;OUT:ROOT;OUT:PL;OUT:3.II
hasaKsi'm_guts'uusgi'm	hasaGa'm	X;IN:ROOT;IN:2PL.II;OUT:ROOT;OUT:1PL.II
K'otst_eejam	K'ojam	X;IN:ROOT;IN:3.II;OUT:ROOT;OUT:ATTR
laya_wanit	lixleyit	X;IN:ROOT;IN:ATTR;OUT:ROOT;OUT:PL;OUT:SX
Galts'ept_Ge'ndiit	Galts'epdiit	X;IN:ROOT;IN:3.II;OUT:ROOT;OUT:3PL.II
gemkt_didalK	gem	X;IN:ROOT;IN:3.II;OUT:ROOT
jabit_guxwin	jebin	X;IN:ROOT;IN:TR;IN:3.II;OUT:ROOT;OUT:TR;OUT:2SG.II
hasaGa'y_wat	hasaGat	X;IN:ROOT;IN:1SG.II;OUT:ROOT;OUT:SX
gyoot_hal'algaXt	loot	X;IN:ROOT;IN:3.II;OUT:ROOT;OUT:PL;OUT:3.II
hogaXdiit_hogaGam	hogaGam	X;IN:ROOT;IN:3PL.II;OUT:ROOT;OUT:ATTR
yetst_dulbin	yets	X;IN:ROOT;IN:3.II;OUT:ROOT
jaXjoKt_Gabiit	joGat	X;IN:ROOT;IN:PL;IN:3.II;OUT:ROOT;OUT:SX
ts'in_'mast	ts'int	X;IN:ROOT;OUT:ROOT;OUT:3.II
laXyipdiit_Gado'o	laXyip	X;IN:ROOT;IN:3PL.II;OUT:ROOT
t'aam_lixleyit	wanit	X;IN:ROOT;IN:ATTR;OUT:ROOT;OUT:PL;OUT:SX
hlguuhlxwi'y_sisipt	hlgit	X;IN:ROOT;IN:1SG.II;OUT:ROOT;OUT:PL;OUT:3.II
yee_Gabiit	yeet	X;IN:ROOT;OUT:ROOT;OUT:3.II
hlo'odiit_hlo'o'm	hlo'o'm	X;IN:ROOT;IN:PL;IN:3PL.II;OUT:ROOT;OUT:PL;OUT:1PL.II
noXdiit_an'ixwt	noXt	X;IN:ROOT;IN:3PL.II;OUT:ROOT;OUT:3.II
hahle'lst_giisdiit	hahle'lstdiit	X;IN:ROOT;IN:3.II;OUT:ROOT;OUT:3PL.II
iilendiit_simihldiit	hilendiit	X;IN:ROOT;IN:3PL.II;OUT:ROOT;OUT:3PL.II
Go'osi'm_tK'a'andiit	Go'odiit	X;IN:ROOT;IN:2PL.II;OUT:ROOT;OUT:3PL.II
hlguts'uus_K'ay'mesi'y	guts'uusgi'y	X;IN:ROOT;OUT:ROOT;OUT:1SG.II
heldit_ts'uusgim	heldim	X;IN:ROOT;IN:SX;OUT:ROOT;OUT:ATTR
ha'wit_hets	ha'w	X;IN:ROOT;IN:3.II;OUT:ROOT
t'amin_diha'w	t'am	X;IN:ROOT;IN:TR;IN:2SG.II;OUT:ROOT
adaawK_dukhlinXt	adaawKt	X;IN:ROOT;OUT:ROOT;OUT:3.II
wili'y_gimxdit	wilt	X;IN:ROOT;IN:1SG.II;OUT:ROOT;OUT:3.II
jept_K'amksiwaamXdiit	jepdiit	X;IN:ROOT;IN:3.II;OUT:ROOT;OUT:3PL.II
alisxw_laahli'm	aliisxu'm	X;IN:ROOT;OUT:ROOT;OUT:PL;OUT:1PL.II
halaaxdiit_gidaXat	wilaayit	X;IN:ROOT;IN:3PL.II;OUT:ROOT;OUT:TR;OUT:3.II
wadiit_ts'eet	wat	X;IN:ROOT;IN:3PL.II;OUT:ROOT;OUT:3.II
mihas'usin_mis'usi'm	mas'usi'm	X;IN:ROOT;IN:PL;IN:2SG.II;OUT:ROOT;OUT:PL;OUT:1PL.II
sGa'wa_Gootdiit	sGa'wadiit	X;IN:ROOT;OUT:ROOT;OUT:3PL.II
woK't_dekhldiit	woK'diit	X;IN:ROOT;IN:3.II;OUT:ROOT;OUT:3PL.II
hlo'odiit_luuhitxwGoot	yee	X;IN:ROOT;IN:PL;IN:3PL.II;OUT:ROOT
saksit_simgigat	saks	X;IN:ROOT;IN:PL;IN:SX;OUT:ROOT;OUT:PL
yeet_dohot	hlo'ot	X;IN:ROOT;IN:3.II;OUT:ROOT;OUT:PL;OUT:SX
Goott_gi'namhlguuhlxw	Goot	X;IN:ROOT;IN:3.II;OUT:ROOT
hahle'lsit_didi'y	hahle'lst	X;IN:ROOT;IN:SX;OUT:ROOT
Galjipts'ep_uu'wt	Galts'ept	X;IN:ROOT;IN:PL;OUT:ROOT;OUT:3.II
'win_anooKdiit	'windiit	X;IN:ROOT;OUT:ROOT;OUT:3PL.II
seksdiit_aliisxw	seks	X;IN:ROOT;IN:PL;IN:3PL.II;OUT:ROOT;OUT:PL
laXyipt_aXalgaX	laXyip	X;IN:ROOT;IN:3.II;OUT:ROOT
amt_huwelixim	am'ama	X;IN:ROOT;IN:3.II;OUT:ROOT;OUT:PL;OUT:ATTR
Gabiit_heldit	Gabit	X;IN:ROOT;IN:3.II;OUT:ROOT;OUT:SX
huwat_kwsdinsit	wat	X;IN:ROOT;IN:PL;IN:3.II;OUT:ROOT;OUT:SX
Xsdaa_wilt	Xsdaat	X;IN:ROOT;OUT:ROOT;OUT:SX
ts'ep_gipaygum	ts'ebim	X;IN:ROOT;OUT:ROOT;OUT:ATTR
'mast_nigwoodi'y	'mesi'y	X;IN:ROOT;IN:3.II;OUT:ROOT;OUT:1SG.II
'nekwt_gilbilt	'negwit	X;IN:ROOT;IN:3.II;OUT:ROOT;OUT:SX
simgiget_lem	simgigat	X;IN:ROOT;IN:PL;OUT:ROOT;OUT:PL
daa'whlt_dexwit	seksit	X;IN:ROOT;IN:3.II;OUT:ROOT;OUT:PL;OUT:SX
sdilt_diyeediit	sdildiit	X;IN:ROOT;IN:3.II;OUT:ROOT;OUT:3PL.II
lidindiit_disekst	lidint	X;IN:ROOT;IN:PL;IN:3PL.II;OUT:ROOT;OUT:PL;OUT:3.II
mismesxw_gyoot	masxwt	X;IN:ROOT;IN:PL;OUT:ROOT;OUT:3.II
bekwt_gwiiladiit	bekwdiit	X;IN:ROOT;IN:PL;IN:3.II;OUT:ROOT;OUT:PL;OUT:3PL.II
giihl_t'ekwt	giihlt	X;IN:ROOT;OUT:ROOT;OUT:3.II
hapdiit_k'i'lixs	tK'esxw	X;IN:ROOT;IN:PL;IN:3PL.II;OUT:ROOT
ha'niiGootdiit_'nii'wa	ha'niiGoot	X;IN:ROOT;IN:3PL.II;OUT:ROOT
mismesxw_office	mesxw	X;IN:ROOT;IN:PL;OUT:ROOT
guut_gyoo	guu	X;IN:ROOT;IN:3.II;OUT:ROOT
sbaaytGan_Xbits'iixw	sbaGaytGanGan	X;IN:ROOT;OUT:ROOT;OUT:PL
saGaytGootdiit_ayawaatxw	saGaytGoot	X;IN:ROOT;IN:3PL.II;OUT:ROOT
yooK_iksdedint	gupt	X;IN:ROOT;OUT:ROOT;OUT:3.II
GedaXdiit_siwadit	gidaXat	X;IN:ROOT;IN:3PL.II;OUT:ROOT;OUT:TR;OUT:3.II
Ganaa'wi'y_'mootxw	Ganaa'w	X;IN:ROOT;IN:1SG.II;OUT:ROOT
he'y_nee	he	X;IN:ROOT;IN:1SG.II;OUT:ROOT
t'ilXoo_guslisdiit	t'ilXo'odiit	X;IN:ROOT;OUT:ROOT;OUT:3PL.II
t'aat_laXyibit	t'aat	X;IN:ROOT;IN:3.II;OUT:ROOT;OUT:SX
tK'esxwit_mukwt	tK'esxwt	X;IN:ROOT;IN:TR;IN:3.II;OUT:ROOT;OUT:3.II
Gani'm_Gaseexw	pole	X;IN:ROOT;IN:1PL.II;OUT:ROOT
t'ihlxw_XsdemGam	t'ihlxum	X;IN:ROOT;OUT:ROOT;OUT:ATTR
jabi'y_wilaayit	jabit	X;IN:ROOT;IN:TR;IN:1SG.II;OUT:ROOT;OUT:TR;OUT:3.II
dibegwit_loo	dibakw	X;IN:ROOT;IN:PL;IN:TR;IN:3.II;OUT:ROOT;OUT:PL
tXooGant_siwendiit	tXooGandiit	X;IN:ROOT;IN:PL;IN:3.II;OUT:ROOT;OUT:PL;OUT:3PL.II
hogaXdiit_gehlim	hugwaGam	X;IN:ROOT;IN:3PL.II;OUT:ROOT;OUT:ATTR
jaXjoKt_waatxwit	joGot	X;IN:ROOT;IN:PL;IN:3.II;OUT:ROOT;OUT:SX
jaXjoGat_wili'y	joGo'y	X;IN:ROOT;IN:PL;IN:SX;OUT:ROOT;OUT:1SG.II
heltt_luuyuxwdiit	heltdiit	X;IN:ROOT;IN:3.II;OUT:ROOT;OUT:3PL.II
ga'a'm_gubi'y	ga'a'y	X;IN:ROOT;IN:1PL.II;OUT:ROOT;OUT:TR;OUT:1SG.II
daa'whlit_liseexwdiit	daa'whldiit	X;IN:ROOT;IN:SX;OUT:ROOT;OUT:3PL.II
hishalaagaX_gidiidoKdiit	hishalaagaXdiit	X;IN:ROOT;IN:PL;OUT:ROOT;OUT:PL;OUT:3PL.II
seksdiit_gigitxsit	seksit	X;IN:ROOT;IN:PL;IN:3PL.II;OUT:ROOT;OUT:PL;OUT:SX
bekw_hlo'ot	bekwt	X;IN:ROOT;IN:PL;OUT:ROOT;OUT:PL;OUT:3.II
Galts'ept_sinhun	Galts'ap	X;IN:ROOT;IN:3.II;OUT:ROOT
wani'm_wanit	want	X;IN:ROOT;IN:PL;IN:1PL.II;OUT:ROOT;OUT:PL;OUT:SX
went_bagu'm	weni'm	X;IN:ROOT;IN:PL;IN:3.II;OUT:ROOT;OUT:PL;OUT:1PL.II
ksimaasdiit_laX'nidiit	ksimaasdiit	X;IN:ROOT;IN:3PL.II;OUT:ROOT;OUT:3PL.II
didalGan_limxt	didelKt	X;IN:ROOT;IN:TR;IN:2SG.II;OUT:ROOT;OUT:3.II
ha'wit_joKdiit	ha'wdiit	X;IN:ROOT;IN:3.II;OUT:ROOT;OUT:3PL.II
jaXjoKdiit_jaXjoGat	jaXjoGot	X;IN:ROOT;IN:PL;IN:3PL.II;OUT:ROOT;OUT:PL;OUT:SX
'witxwi'y_tXooGandiit	bekwdiit	X;IN:ROOT;IN:1SG.II;OUT:ROOT;OUT:PL;OUT:3PL.II
hlgit_hlgi'y	hlgi'y	X;IN:ROOT;IN:PL;IN:3.II;OUT:ROOT;OUT:PL;OUT:1SG.II
Goldiit_Golt	Golt	X;IN:ROOT;IN:PL;IN:3PL.II;OUT:ROOT;OUT:PL;OUT:3.II
doGo'm_hashejit	doGot	X;IN:ROOT;IN:PL;IN:TR;IN:1PL.II;OUT:ROOT;OUT:PL;OUT:TR;OUT:3.II
went_kw'asint	t'aat	X;IN:ROOT;IN:PL;IN:3.II;OUT:ROOT;OUT:3.II
'mesi'y_wegi'y	'masi'y	X;IN:ROOT;IN:1SG.II;OUT:ROOT;OUT:1SG.II
hahle'lsdi'm_bitxwit	hahle'lsit	X;IN:ROOT;IN:1PL.II;OUT:ROOT;OUT:SX
weni'm_loKt	t'aat	X;IN:ROOT;IN:PL;IN:1PL.II;OUT:ROOT;OUT:3.II
K'otst_ayawaatxwdiit	K'otsdiit	X;IN:ROOT;IN:3.II;OUT:ROOT;OUT:3PL.II
sdilt_hlo'o'm	sdili'm	X;IN:ROOT;IN:3.II;OUT:ROOT;OUT:1PL.II
'wat_luuyuxw	'wa	X;IN:ROOT;IN:3.II;OUT:ROOT
gubi'm_'mootxw	gup	X;IN:ROOT;IN:TR;IN:1PL.II;OUT:ROOT
dexwdiit_'nu'wit	'nu'wit	X;IN:ROOT;IN:PL;IN:3PL.II;OUT:ROOT;OUT:SX
'nekwt_silkw	'nakw	X;IN:ROOT;IN:3.II;OUT:ROOT
woowaX_miint	woKt	X;IN:ROOT;IN:PL;OUT:ROOT;OUT:3.II
algaXa'y_lim	algaX	X;IN:ROOT;IN:1SG.II;OUT:ROOT
wisi'm_isin	win	X;IN:ROOT;IN:2PL.II;OUT:ROOT;OUT:2SG.II
gubit_sbaGaytGanGan	tXooK	X;IN:ROOT;IN:TR;IN:3.II;OUT:ROOT;OUT:PL
lidindiit_wilp	hitin	X;IN:ROOT;IN:PL;IN:3PL.II;OUT:ROOT
Galts'ap_gwilat	Galts'ept	X;IN:ROOT;OUT:ROOT;OUT:3.II
ayawaatxw_ksimaasdiit	ayawaatxwdiit	X;IN:ROOT;OUT:ROOT;OUT:3PL.II
baX_hlo'ot	Golt	X;IN:ROOT;OUT:ROOT;OUT:PL;OUT:3.II
wil'naat'ehlt_anjapt	wil'naat'ahlt	X;IN:ROOT;IN:3.II;OUT:ROOT;OUT:3.II
baXyuxw_japdiit	baXyuxwdiithl	X;IN:ROOT;OUT:ROOT;OUT:3PL.II
GaGoott_Ge'ndiit	Gootdiit	X;IN:ROOT;IN:PL;IN:3.II;OUT:ROOT;OUT:3PL.II
wendiit_hlo'ot	wanit	X;IN:ROOT;IN:PL;IN:3PL.II;OUT:ROOT;OUT:PL;OUT:SX
gem_hloXsa	gemgim	X;IN:ROOT;OUT:ROOT;OUT:ATTR
se'et_hlo'odiit	sise'ediit	X;IN:ROOT;IN:3.II;OUT:ROOT;OUT:PL;OUT:3PL.II
gimxdiidiit_sGat'akwt	gimxdit	X;IN:ROOT;IN:3PL.II;OUT:ROOT;OUT:3.II
dibakwdiit_ts'ee'w	dikw'itxw	X;IN:ROOT;IN:PL;IN:3PL.II;OUT:ROOT
am'amit_heldit	amit	X;IN:ROOT;IN:PL;IN:SX;OUT:ROOT;OUT:SX
wat_hediit	wadiit	X;IN:ROOT;IN:3.II;OUT:ROOT;OUT:3PL.II
went_mis'usi'm	wani'm	X;IN:ROOT;IN:PL;IN:SX;OUT:ROOT;OUT:PL;OUT:1PL.II
GasGoo_ts'int	GasGoot	X;IN:ROOT;OUT:ROOT;OUT:3.II
'nu'wt_hahlo'o	dexw	X;IN:ROOT;IN:SX;OUT:ROOT;OUT:PL
t'aat_laXlaK	wan	X;IN:ROOT;IN:SX;OUT:ROOT;OUT:PL
dibekw_hlgit	dibekwt	X;IN:ROOT;IN:PL;OUT:ROOT;OUT:PL;OUT:3.II
yee'y_t'aX	yee	X;IN:ROOT;IN:1SG.II;OUT:ROOT
t'aa_huudindiit	wandiit	X;IN:ROOT;OUT:ROOT;OUT:PL;OUT:3PL.II
jepdiit_hlimoo'ldiit	japdiit	X;IN:ROOT;IN:3PL.II;OUT:ROOT;OUT:3PL.II
we'y_GaGoott	huwat	X;IN:ROOT;IN:1SG.II;OUT:ROOT;OUT:PL;OUT:3.II
sGa'wadiit_ts'ak'	sGa'wa	X;IN:ROOT;IN:3PL.II;OUT:ROOT
waatxwt_gyoot	waatxwt	X;IN:ROOT;IN:3.II;OUT:ROOT;OUT:3.II
ts'ehlX_liiluxwdiit	hishalaagaXdiit	X;IN:ROOT;OUT:ROOT;OUT:PL;OUT:3PL.II
ayawaatxw_nakst	ayawaatxwt	X;IN:ROOT;OUT:ROOT;OUT:3.II
saksit_loo	seks	X;IN:ROOT;IN:PL;IN:SX;OUT:ROOT;OUT:PL
wiyitxwt_anooKdiit	wiyitsxwdiit	X;IN:ROOT;IN:3.II;OUT:ROOT;OUT:3PL.II
gwilat_sdik'eegwin	gwilan	X;IN:ROOT;IN:3.II;OUT:ROOT;OUT:2SG.II
hahle'lst_aamit	hahla'ljit	X;IN:ROOT;OUT:ROOT;OUT:SX
ha'wt_niye'et	ha'wit	X;IN:ROOT;IN:3.II;OUT:ROOT;OUT:3.II
daa'whldiit_t'ipXaadit	daa'whlit	X;IN:ROOT;IN:3PL.II;OUT:ROOT;OUT:SX
nigwootdiit_hlams	nigwoot	X;IN:ROOT;IN:3PL.II;OUT:ROOT
wilt_sdik'eegwin	win	X;IN:ROOT;IN:SX;OUT:ROOT;OUT:2SG.II
t'aan_huwat	want	X;IN:ROOT;IN:2SG.II;OUT:ROOT;OUT:PL;OUT:3.II
joGo'm_joGat	joGat	X;IN:ROOT;IN:1PL.II;OUT:ROOT;OUT:SX
hlgim_hlgi'y	hlgi'y	X;IN:ROOT;IN:PL;IN:ATTR;OUT:ROOT;OUT:PL;OUT:1SG.II
hlguts'uusgi'y_sdili'm	hlguts'uusgi'm	X;IN:ROOT;IN:1SG.II;OUT:ROOT;OUT:1PL.II
a'laXan_mo'ont	a'laXt	X;IN:ROOT;IN:2SG.II;OUT:ROOT;OUT:3.II
luuhitxwGootdiit_Xpts'exw	luuhitxwGoot	X;IN:ROOT;IN:3PL.II;OUT:ROOT
baGadilt_yee'm	baGadili'm	X;IN:ROOT;IN:SX;OUT:ROOT;OUT:1PL.II
dexw_hahla'ljit	'nu'wt	X;IN:ROOT;IN:PL;OUT:ROOT;OUT:SX
noXt_K'ay'mesi'y	noXo'y	X;IN:ROOT;IN:3.II;OUT:ROOT;OUT:1SG.II
seksit_huks	daa'whl	X;IN:ROOT;IN:PL;IN:SX;OUT:ROOT
dildilsdiit_mis'usi'm	didilsdi'm	X;IN:ROOT;IN:PL;IN:3PL.II;OUT:ROOT;OUT:PL;OUT:1PL.II
hugwaGam_luuyuxwdiit	hogaXdiit	X;IN:ROOT;IN:ATTR;OUT:ROOT;OUT:3PL.II
gubit_dawt	gupt	X;IN:ROOT;IN:TR;IN:3.II;OUT:ROOT;OUT:3.II
Galjipts'ep_'witxwi'y	Galts'ebi'y	X;IN:ROOT;IN:PL;OUT:ROOT;OUT:1SG.II
wilda_wiyitxw	wil	X;IN:ROOT;IN:3PL;OUT:ROOT
jaXjoGot_jaXjoGat	jaXjoGat	X;IN:ROOT;IN:PL;IN:SX;OUT:ROOT;OUT:PL;OUT:SX
GaGoott_hisyetsdiit	GaGootdiit	X;IN:ROOT;IN:PL;IN:3.II;OUT:ROOT;OUT:PL;OUT:3PL.II
wandiit_sdint	t'aat	X;IN:ROOT;IN:PL;IN:3PL.II;OUT:ROOT;OUT:3.II
hasaKdiit_anhahla'lsdi'y	hasaGa'y	X;IN:ROOT;IN:3PL.II;OUT:ROOT;OUT:1SG.II
gidaX_woKt	gidaXt	X;IN:ROOT;OUT:ROOT;OUT:3.II
wil_hasaKsi'm	wilsi'm	X;IN:ROOT;OUT:ROOT;OUT:2PL.II
halaakwdiit_gimxdi	halaakw	X;IN:ROOT;IN:3PL.II;OUT:ROOT
hahle'lst_nooGa'y	hahla'lsdi'y	X;IN:ROOT;IN:3.II;OUT:ROOT;OUT:1SG.II
maKdiit_woowaX	t'ehl	X;IN:ROOT;IN:3PL.II;OUT:ROOT;OUT:PL
doGot_huwilpt	doKt	X;IN:ROOT;IN:PL;IN:TR;IN:3.II;OUT:ROOT;OUT:PL;OUT:3.II
gipaykw_limXs	gipaykw	X;IN:ROOT;OUT:ROOT;OUT:PL
want_saahlo'odiit	wandiit	X;IN:ROOT;IN:PL;IN:SX;OUT:ROOT;OUT:PL;OUT:3PL.II
seksdiit_t'ipXoo'ldit	daa'whlit	X;IN:ROOT;IN:PL;IN:3PL.II;OUT:ROOT;OUT:SX
hasaGa'y_haboo'lt	hasaKt	X;IN:ROOT;IN:1SG.II;OUT:ROOT;OUT:3.II
Xdeyi'm_luxdaxdiit	luxdaxdiit	X;IN:ROOT;IN:1PL.II;OUT:PL;OUT:ROOT;OUT:3PL.II
maK_saks	t'ahl	X;IN:ROOT;OUT:ROOT;OUT:PL
amit_am'ama	am'ama	X;IN:ROOT;IN:SX;OUT:ROOT;OUT:PL;OUT:ATTR
am'ama_daha'wit	amt	X;IN:ROOT;IN:PL;IN:ATTR;OUT:ROOT;OUT:3.II
naX'nidiit_naX'niyit	naX'niyit	X;IN:ROOT;IN:3PL.II;OUT:ROOT;OUT:TR;OUT:3.II
al'alGalt_se'et	alGalt	X;IN:ROOT;IN:PL;IN:3.II;OUT:ROOT;OUT:3.II
t'aan_hlo'o'm	wani'm	X;IN:ROOT;IN:2SG.II;OUT:ROOT;OUT:PL;OUT:1PL.II
gi'nami'y_noXt	gi'namt	X;IN:ROOT;IN:TR;IN:1SG.II;OUT:ROOT;OUT:3.II
wilt_Go'osi'm	wilsi'm	X;IN:ROOT;IN:3.II;OUT:ROOT;OUT:2PL.II
sit'aa_laahl	siwen	X;IN:ROOT;OUT:ROOT;OUT:PL
yeet_ky'ult	yeet	X;IN:ROOT;IN:3.II;OUT:ROOT;OUT:SX
wilt_wildigitxwdiit	wildiit	X;IN:ROOT;IN:SX;OUT:ROOT;OUT:3PL.II
loodiit_t'ehl	gyoo	X;IN:ROOT;IN:PL;IN:3PL.II;OUT:ROOT
joGo'y_gigi'ydiit	jaXjoKdiit	X;IN:ROOT;IN:1SG.II;OUT:ROOT;OUT:PL;OUT:3PL.II
t'aham_anjipts'ap	dit'aX	X;IN:ROOT;IN:ATTR;OUT:ROOT;OUT:PL
joGat_dexwit	jaXjoGat	X;IN:ROOT;IN:SX;OUT:ROOT;OUT:PL;OUT:SX
t'aam_saksit	went	X;IN:ROOT;IN:ATTR;OUT:ROOT;OUT:PL;OUT:SX
amet_winee	amhe	X;IN:ROOT;IN:3.II;OUT:ROOT
dibakwdiit_hashejit	dibegwit	X;IN:ROOT;IN:PL;IN:3PL.II;OUT:ROOT;OUT:PL;OUT:TR;OUT:3.II
daXgadim_algaXa'm	daXgedi'm	X;IN:ROOT;IN:ATTR;OUT:ROOT;OUT:1PL.II
alisxu'm_jaXjoGo'm	aliisxu'm	X;IN:ROOT;IN:1PL.II;OUT:ROOT;OUT:PL;OUT:1PL.II
sGa'wat_nigwootdiit	sGa'wadiit	X;IN:ROOT;IN:3.II;OUT:ROOT;OUT:3PL.II
joGot_algaXdiit	joKdiit	X;IN:ROOT;IN:SX;OUT:ROOT;OUT:3PL.II
daa'whl_dexwit	saksit	X;IN:ROOT;OUT:ROOT;OUT:PL;OUT:SX
noXo'm_Galts'ebi'y	noXa'y	X;IN:ROOT;IN:1PL.II;OUT:ROOT;OUT:1SG.II
dibekwt_went	dibekwt	X;IN:ROOT;IN:PL;IN:3.II;OUT:ROOT;OUT:PL;OUT:3.II
wilaayisi'm_wildigitxwdiit	halaaxdiit	X;IN:ROOT;IN:TR;IN:2PL.II;OUT:ROOT;OUT:3PL.II
hlguts'uusxt_gut'ihlxwi'y	hlguts'uusgi'y	X;IN:ROOT;IN:3.II;OUT:ROOT;OUT:1SG.II
sdik'eekwt_yee	sdik'eekw	X;IN:ROOT;IN:3.II;OUT:ROOT
gint_sip	gin	X;IN:ROOT;IN:3.II;OUT:ROOT
sa'anjoK_jekwdiit	sa'anjoKdiit	X;IN:ROOT;OUT:ROOT;OUT:3PL.II
Galts'ebi'y_hishalaagaX	Galjipts'ep	X;IN:ROOT;IN:1SG.II;OUT:ROOT;OUT:PL
gint_giisdiit	gindiit	X;IN:ROOT;IN:3.II;OUT:ROOT;OUT:3PL.II
daa'whlt_aliisxw	saks	X;IN:ROOT;IN:3.II;OUT:ROOT;OUT:PL
wildigitxwdiit_k'i'yt	wildigitxwit	X;IN:ROOT;IN:3PL.II;OUT:ROOT;OUT:SX
joGo'm_liiluxwdiit	jaXjoKdiit	X;IN:ROOT;IN:1PL.II;OUT:ROOT;OUT:PL;OUT:3PL.II
hasaKt_Goodi'y	hasaGa'y	X;IN:ROOT;IN:3.II;OUT:ROOT;OUT:1SG.II
hlguuhlxwi'y_office'y	hlguuhlxwi'yaa	X;IN:ROOT;IN:1SG.II;OUT:ROOT;OUT:1SG.II
went_luutK'alno'o	t'aa	X;IN:ROOT;IN:PL;IN:3.II;OUT:ROOT
jebi'y_looykt	jept	X;IN:ROOT;IN:TR;IN:1SG.II;OUT:ROOT;OUT:3.II
wendiit_al'alGaldiit	wandiit	X;IN:ROOT;IN:PL;IN:3PL.II;OUT:ROOT;OUT:PL;OUT:3PL.II
limXsim_'witxwi'y	'mesi'y	X;IN:ROOT;IN:PL;IN:ATTR;OUT:ROOT;OUT:1SG.II
ayawaatxwdiit_saGaytGoodat	ayawaatxwt	X;IN:ROOT;IN:3PL.II;OUT:ROOT;OUT:3.II
halaaxt_laXlaK	huwilaa	X;IN:ROOT;IN:3.II;OUT:ROOT;OUT:PL
k'eeKin_luut'ehldiit	huudindiit	X;IN:ROOT;OUT:ROOT;OUT:PL;OUT:3PL.II
gimxdit_yuuhlimXdiit	gimxdiidiit	X;IN:ROOT;IN:3.II;OUT:ROOT;OUT:3PL.II
joKt_saksit	jaXjoGat	X;IN:ROOT;IN:3.II;OUT:ROOT;OUT:PL;OUT:SX
nigwoodi'y_xwdaxt	nigwoott	X;IN:ROOT;IN:1SG.II;OUT:ROOT;OUT:3.II
bekwt_Galts'ebi'y	'witxwi'y	X;IN:ROOT;IN:PL;IN:3.II;OUT:ROOT;OUT:1SG.II
baXyuxwdiithl_gidaXdiit	baXyuxwdiithl	X;IN:ROOT;IN:3PL.II;OUT:ROOT;OUT:3PL.II
siwen_diyeediit	sit'aadiit	X;IN:ROOT;IN:PL;OUT:ROOT;OUT:3PL.II
ts'int_sdil	ts'in	X;IN:ROOT;IN:3.II;OUT:ROOT
woKt_didilsdi'm	woowaXa'm	X;IN:ROOT;IN:3.II;OUT:ROOT;OUT:PL;OUT:1PL.II
nigwoodi'y_a'laXa'm	nigwoodi'm	X;IN:ROOT;IN:1SG.II;OUT:ROOT;OUT:1PL.II
daha'wit_ayooKt	daha'wt	X;IN:ROOT;IN:3.II;OUT:ROOT;OUT:3.II
hahla'ljit_guxwt	hahle'lst	X;IN:ROOT;IN:SX;OUT:ROOT;OUT:3.II
dexwt_hisyetsdiit	dexwdiit	X;IN:ROOT;IN:PL;IN:3.II;OUT:ROOT;OUT:PL;OUT:3PL.II
'maXsim_amhalayt	'maXs	X;IN:ROOT;IN:ATTR;OUT:ROOT
amhalaytt_Getxwt	amhalaytt	X;IN:ROOT;IN:3.II;OUT:ROOT;OUT:3.II
wilsi'm_hapdiit	wildiit	X;IN:ROOT;IN:2PL.II;OUT:ROOT;OUT:3PL.II
jaXjoGot_saabekwdiit	jaXjoKdiit	X;IN:ROOT;IN:PL;IN:SX;OUT:ROOT;OUT:PL;OUT:3PL.II
nibip_Galts'ebi'y	nibibi'y	X;IN:ROOT;OUT:ROOT;OUT:1SG.II
ga'at_wat	ga'at	X;IN:ROOT;IN:TR;IN:3.II;OUT:ROOT;OUT:3.II
ayukwsdiit_hogaGam	ayukwsim	X;IN:ROOT;IN:3PL.II;OUT:ROOT;OUT:ATTR
ga'a_anhahla'lsdi'y	ga'a'y	X;IN:ROOT;OUT:ROOT;OUT:1SG.II
dawt_laXu	dew	X;IN:ROOT;IN:3.II;OUT:ROOT
heltt_ama	helda	X;IN:ROOT;IN:3.II;OUT:ROOT;OUT:ATTR
gipaykwt_tK'alitt	gipaykwt	X;IN:ROOT;IN:3.II;OUT:ROOT;OUT:PL;OUT:3.II
ayooGa'm_maGoont	ayooKt	X;IN:ROOT;IN:1PL.II;OUT:ROOT;OUT:3.II
'nu'wdiit_xsa'aKxw	'nu'w	X;IN:ROOT;IN:3PL.II;OUT:ROOT
ga'a'm_baasxi'y	ga'a'y	X;IN:ROOT;IN:TR;IN:1PL.II;OUT:ROOT;OUT:TR;OUT:1SG.II
saabekwdiit_jaXjoKdiit	saabekwdiit	X;IN:ROOT;IN:PL;IN:3PL.II;OUT:ROOT;OUT:PL;OUT:3PL.II
bekwdiit_ha'win	'witxw	X;IN:ROOT;IN:PL;IN:3PL.II;OUT:ROOT
daXgett_Xdeyi'm	daXgedi'm	X;IN:ROOT;IN:3.II;OUT:ROOT;OUT:1PL.II
'yenst_andabim	'yensa	X;IN:ROOT;IN:3.II;OUT:ROOT;OUT:ATTR
t'isim_Gan'mala	t'is	X;IN:ROOT;IN:ATTR;OUT:ROOT
liksgedim_t'aham	lixsgadim	X;IN:ROOT;IN:ATTR;OUT:ROOT;OUT:ATTR
yeet_'wa	yee	X;IN:ROOT;IN:3.II;OUT:ROOT
jaXjoGot_al'alGalt	jaXjoKt	X;IN:ROOT;IN:PL;IN:SX;OUT:ROOT;OUT:PL;OUT:3.II
hasaGa'y_gidaXa'm	hasaGa'm	X;IN:ROOT;IN:1SG.II;OUT:ROOT;OUT:1PL.II
Galts'ebi'y_sdildiit	Galts'epdiit	X;IN:ROOT;IN:1SG.II;OUT:ROOT;OUT:3PL.II
guts'uusgi'm_ant'aahl	hlguts'uus	X;IN:ROOT;IN:1PL.II;OUT:ROOT
hilen_hapdiit	hilendiit	X;IN:ROOT;OUT:ROOT;OUT:3PL.II
wadiit_bahani'm	wa'm	X;IN:ROOT;IN:3PL.II;OUT:ROOT;OUT:1PL.II
dibekwt_Galjipts'ep	dibakw	X;IN:ROOT;IN:PL;IN:3.II;OUT:ROOT;OUT:PL
jebi'y_hasbagyoot	japt	X;IN:ROOT;IN:TR;IN:1SG.II;OUT:ROOT;OUT:3.II
'waat'aX_guk'uuhl	'wiidaX	X;IN:ROOT;IN:PL;OUT:ROOT;OUT:PL
ga'at_hooyi'y	ga'a'y	X;IN:ROOT;IN:TR;IN:3.II;OUT:ROOT;OUT:TR;OUT:1SG.II
doXt_hlo'ot	dohot	X;IN:ROOT;IN:PL;IN:3.II;OUT:ROOT;OUT:PL;OUT:SX
weni'm_gipaykwt	want	X;IN:ROOT;IN:PL;IN:1PL.II;OUT:ROOT;OUT:PL;OUT:3.II
ksimaasdiit_giis	ksimaas	X;IN:ROOT;IN:3PL.II;OUT:ROOT
doXt_sdik'eekw	sgi	X;IN:ROOT;IN:PL;IN:3.II;OUT:ROOT
yukwdiit_ts'eet	yukwt	X;IN:ROOT;IN:3PL.II;OUT:ROOT;OUT:3.II
ma'us_mihas'usin	mihas'usin	X;IN:ROOT;OUT:ROOT;OUT:PL;OUT:2SG.II
t'aat_hlk'uba	wen	X;IN:ROOT;IN:SX;OUT:ROOT;OUT:PL
gindiit_hlis	gin	X;IN:ROOT;IN:3PL.II;OUT:ROOT
seksdiit_mihas'us	saks	X;IN:ROOT;IN:PL;IN:3PL.II;OUT:ROOT;OUT:PL
huudini'm_nigwoodi'm	k'eeGani'm	X;IN:ROOT;IN:PL;IN:TR;IN:1PL.II;OUT:ROOT;OUT:1PL.II
begu'm_we'y	'witxwi'y	X;IN:ROOT;IN:PL;IN:1PL.II;OUT:ROOT;OUT:1SG.II
jabit_do'o	jep	X;IN:ROOT;IN:TR;IN:3.II;OUT:ROOT
Goodin_hlooGo'm	Goodi'm	X;IN:ROOT;IN:2SG.II;OUT:ROOT;OUT:1PL.II
joGat_das	joK	X;IN:ROOT;IN:SX;OUT:ROOT
wan_hlaahlaXtt	want	X;IN:ROOT;IN:PL;OUT:ROOT;OUT:PL;OUT:3.II
anooKdiit_algaXt	anooKt	X;IN:ROOT;IN:3PL.II;OUT:ROOT;OUT:3.II
sa'anjoKdiit_miindiit	sa'anjoKdiit	X;IN:ROOT;IN:3PL.II;OUT:ROOT;OUT:3PL.II
bekwdiit_ii'wxwt	bakw	X;IN:ROOT;IN:PL;IN:3PL.II;OUT:ROOT;OUT:PL
hlgidiit_t'ahl	hlgi	X;IN:ROOT;IN:PL;IN:3PL.II;OUT:ROOT;OUT:PL
wen_eejam	t'aam	X;IN:ROOT;IN:PL;OUT:ROOT;OUT:ATTR
noXa'y_yukw	noX	X;IN:ROOT;IN:1SG.II;OUT:ROOT
t'ehldiit_sisatxwdiit	maKdiit	X;IN:ROOT;IN:PL;IN:3PL.II;OUT:ROOT;OUT:3PL.II
se'e_saabekwdiit	sise'ediit	X;IN:ROOT;OUT:ROOT;OUT:PL;OUT:3PL.II
dibegwit_xseeK	dibekw	X;IN:ROOT;IN:PL;IN:TR;IN:3.II;OUT:ROOT;OUT:PL
gatt_'maXsim	gedim	X;IN:ROOT;IN:3.II;OUT:ROOT;OUT:ATTR
gwiladiit_hit'	gwila	X;IN:ROOT;IN:3PL.II;OUT:ROOT
gupt_ts'iigwini'm	gubi'm	X;IN:ROOT;IN:3.II;OUT:ROOT;OUT:TR;OUT:1PL.II
dibegwit_jehlit	da'witxwit	X;IN:ROOT;IN:PL;IN:TR;IN:3.II;OUT:ROOT;OUT:TR;OUT:3.II
gemkt_loo	lem	X;IN:ROOT;IN:3.II;OUT:ROOT;OUT:PL
daa'whlt_jiksindiit	daa'whldiit	X;IN:ROOT;IN:3.II;OUT:ROOT;OUT:3PL.II
Goodi'y_t'aan	Goodin	X;IN:ROOT;IN:1SG.II;OUT:ROOT;OUT:2SG.II
gipaykwt_sbaGaytGanGan	gipaykw	X;IN:ROOT;IN:PL;IN:3.II;OUT:ROOT;OUT:PL
ts'ehlX_haanaK'	hishalaagaX	X;IN:ROOT;OUT:ROOT;OUT:PL
t'ilXoo'y_aksdiit	t'ilXo'odiit	X;IN:ROOT;IN:1SG.II;OUT:ROOT;OUT:3PL.II
'nu'wit_limxt	'nu'wt	X;IN:ROOT;IN:SX;OUT:ROOT;OUT:3.II
saksdiit_saabekwt	sekst	X;IN:ROOT;IN:PL;IN:3PL.II;OUT:ROOT;OUT:PL;OUT:3.II
jisjahlit_hogaXat	jehlit	X;IN:ROOT;IN:PL;IN:TR;IN:3.II;OUT:ROOT;OUT:TR;OUT:3.II
'windiit_mahl	'win	X;IN:ROOT;IN:3PL.II;OUT:ROOT
ksimaas_luuyuxwdiit	ksimaasdiit	X;IN:ROOT;OUT:ROOT;OUT:3PL.II
siwendiit_limXs	siwen	X;IN:ROOT;IN:PL;IN:3PL.II;OUT:ROOT;OUT:PL
wilsi'm_k'eeGani'm	wili'm	X;IN:ROOT;IN:2PL.II;OUT:ROOT;OUT:1PL.II
didelKdiit_guksint	didelKt	X;IN:ROOT;IN:3PL.II;OUT:ROOT;OUT:3.II
t'aat_lixleyit	wanit	X;IN:ROOT;IN:SX;OUT:ROOT;OUT:PL;OUT:SX
Xde_luxdaxdiit	luxdaxdiit	X;IN:ROOT;OUT:PL;OUT:ROOT;OUT:3PL.II
aat'ikt_k'etsxw	aat'iks	X;IN:ROOT;IN:3.II;OUT:ROOT
lukw_yeet	lukwt	X;IN:ROOT;OUT:ROOT;OUT:3.II
joGat_hahla'ljit	joGot	X;IN:ROOT;IN:SX;OUT:ROOT;OUT:SX
noXo'y_gett	noXt	X;IN:ROOT;IN:1SG.II;OUT:ROOT;OUT:3.II
gin_sa'anjoKdiit	gindiit	X;IN:ROOT;OUT:ROOT;OUT:3PL.II
ha'wi'm_Galhuksindiit	ha'wdiit	X;IN:ROOT;IN:1PL.II;OUT:ROOT;OUT:3PL.II
wilaayisi'm_guseeKt	wilaaxt	X;IN:ROOT;IN:TR;IN:2PL.II;OUT:ROOT;OUT:3.II
hlguts'uus_ts'atxwt	hlguts'uusxt	X;IN:ROOT;OUT:ROOT;OUT:3.II
we'y_haboo'lt	wat	X;IN:ROOT;IN:1SG.II;OUT:ROOT;OUT:3.II
huks_win	huksin	X;IN:ROOT;OUT:ROOT;OUT:2SG.II
joK_lukwt	joKt	X;IN:ROOT;OUT:ROOT;OUT:3.II
yuwit_niye'et	yuxwt	X;IN:ROOT;IN:TR;IN:3.II;OUT:ROOT;OUT:3.II
guxw_umKxwt	guxwt	X;IN:ROOT;OUT:ROOT;OUT:3.II
neksim_'malt	nakst	X;IN:ROOT;IN:ATTR;OUT:ROOT;OUT:3.II
baKt_mahldiit	baKdiit	X;IN:ROOT;IN:3.II;OUT:ROOT;OUT:3PL.II
wandiit_'nu'wit	t'aat	X;IN:ROOT;IN:PL;IN:3PL.II;OUT:ROOT;OUT:SX
he'm_hen	hen	X;IN:ROOT;IN:1PL.II;OUT:ROOT;OUT:2SG.II
t'am_guseeKt	t'amt	X;IN:ROOT;OUT:ROOT;OUT:3.II
t'ilXoo'y_laXu	t'ilXoo	X;IN:ROOT;IN:1SG.II;OUT:ROOT
Goodi'm_niye'e'y	Goodi'y	X;IN:ROOT;IN:1PL.II;OUT:ROOT;OUT:1SG.II
sgi_ha'niiGootdiit	sgidiit	X;IN:ROOT;OUT:ROOT;OUT:3PL.II
we'y_tK'am'ut	wet	X;IN:ROOT;IN:1SG.II;OUT:ROOT;OUT:3.II
hishalaagaX_ts'iigwin	ts'ehlX	X;IN:ROOT;IN:PL;OUT:ROOT
yuwit_luu'nu'w	yuxw	X;IN:ROOT;IN:TR;IN:3.II;OUT:ROOT
GasGoot_laaGalt	GasGoot	X;IN:ROOT;IN:SX;OUT:ROOT;OUT:3.II
wat_guts'uusgi'y	we'y	X;IN:ROOT;IN:SX;OUT:ROOT;OUT:1SG.II
Goodi'y_huwilpt	GaGoott	X;IN:ROOT;IN:1SG.II;OUT:ROOT;OUT:PL;OUT:3.II
ts'epdiit_gipaygum	ts'ebim	X;IN:ROOT;IN:3PL.II;OUT:ROOT;OUT:ATTR
daa'whl_am'amt	sekst	X;IN:ROOT;OUT:ROOT;OUT:PL;OUT:3.II
tXalpX_yeet	tXalpXat	X;IN:ROOT;OUT:ROOT;OUT:SX
baGadilim_ment	baGadilt	X;IN:ROOT;IN:ATTR;OUT:ROOT;OUT:SX
K'otst_hanwilaakw	K'ots	X;IN:ROOT;IN:3.II;OUT:ROOT
daXgedi'm_silim	daXgat	X;IN:ROOT;IN:1PL.II;OUT:ROOT
K'ojam_t'imGes	K'ots	X;IN:ROOT;IN:ATTR;OUT:ROOT
kwsdinst_k'i'yt	kwsdinsit	X;IN:ROOT;IN:3.II;OUT:ROOT;OUT:SX
uu'w_Xa'nit	uu'wt	X;IN:ROOT;OUT:ROOT;OUT:3.II
hlgi'y_K'ots	hlguuhlxw	X;IN:ROOT;IN:PL;IN:1SG.II;OUT:ROOT
hlguuhlxw_sekst	hlgit	X;IN:ROOT;OUT:ROOT;OUT:PL;OUT:3.II
want_laXyibit	t'aat	X;IN:ROOT;IN:PL;IN:SX;OUT:ROOT;OUT:SX
'witxwt_amgiikw	'witxw	X;IN:ROOT;IN:3.II;OUT:ROOT
wekt_ayukws	wa	X;IN:ROOT;IN:3.II;OUT:ROOT
ayukwsi'm_anbisxw	ayukws	X;IN:ROOT;IN:1PL.II;OUT:ROOT
GaGoott_hit	Goot	X;IN:ROOT;IN:PL;IN:3.II;OUT:ROOT
nigwoodi'y_das	nigwoot	X;IN:ROOT;IN:1SG.II;OUT:ROOT
tK'esxwit_lit	hap	X;IN:ROOT;IN:TR;IN:3.II;OUT:ROOT;OUT:PL
wil'naat'ahlt_hlibuu	wil'naat'ehl	X;IN:ROOT;IN:3.II;OUT:ROOT
gigitxsit_Gant	gitxt	X;IN:ROOT;IN:PL;IN:SX;OUT:ROOT;OUT:3.II
Xa'nit_iksde	Xa'ni	X;IN:ROOT;IN:3.II;OUT:ROOT
hlgi'y_t'aham	hlguuhlxum	X;IN:ROOT;IN:PL;IN:1SG.II;OUT:ROOT;OUT:ATTR
luuwent_huutdiit	luuwendiit	X;IN:ROOT;IN:PL;IN:3.II;OUT:ROOT;OUT:PL;OUT:3PL.II
jiksindiit_toost	jiksin	X;IN:ROOT;IN:3PL.II;OUT:ROOT
hooyit_niye'et	hooxt	X;IN:ROOT;IN:TR;IN:3.II;OUT:ROOT;OUT:3.II
am'amt_dexwit	am'amit	X;IN:ROOT;IN:PL;IN:3.II;OUT:ROOT;OUT:PL;OUT:SX
salimxdiit_ayukws	silim	X;IN:ROOT;IN:3PL.II;OUT:ROOT
Goodin_hligwi	Goot	X;IN:ROOT;IN:2SG.II;OUT:ROOT
doKt_ha'niilaahl	doK	X;IN:ROOT;IN:PL;IN:3.II;OUT:ROOT;OUT:PL
t'ilXoo'y_kwsdins	t'ilXoo	X;IN:ROOT;IN:1SG.II;OUT:ROOT
dibakw_huutdiit	dibakwdiit	X;IN:ROOT;IN:PL;OUT:ROOT;OUT:PL;OUT:3PL.II
halaa_gi'nami'y	wilaayi'y	X;IN:ROOT;OUT:ROOT;OUT:TR;OUT:1SG.II
hogaXat_tK'esxw	hogaX	X;IN:ROOT;IN:TR;IN:3.II;OUT:ROOT
baGadil_laXyibi'm	baGadili'm	X;IN:ROOT;OUT:ROOT;OUT:1PL.II
sgit_saksit	dohot	X;IN:ROOT;IN:3.II;OUT:ROOT;OUT:PL;OUT:SX
doKdiit_siwen	doK	X;IN:ROOT;IN:PL;IN:3PL.II;OUT:ROOT;OUT:PL
t'aXdiit_'mesim	t'aham	X;IN:ROOT;IN:3PL.II;OUT:ROOT;OUT:ATTR
doKt_guut	guut	X;IN:ROOT;IN:PL;IN:3.II;OUT:ROOT;OUT:3.II
Golt_da'aKhlxwi'y	baXa'y	X;IN:ROOT;IN:PL;IN:3.II;OUT:ROOT;OUT:1SG.II
sgidiit_lidint	doXt	X;IN:ROOT;IN:3PL.II;OUT:ROOT;OUT:PL;OUT:3.II
mitin_hahle'lsdiit	midindiit	X;IN:ROOT;OUT:ROOT;OUT:3PL.II
am'amit_'masxwt	amt	X;IN:ROOT;IN:PL;IN:SX;OUT:ROOT;OUT:3.II
hasaKt_didi'ydiit	hasaKdiit	X;IN:ROOT;IN:3.II;OUT:ROOT;OUT:3PL.II
joGo'm_Galts'ebi'y	joGo'y	X;IN:ROOT;IN:1PL.II;OUT:ROOT;OUT:1SG.II
Gabiit_t'ipXaadit	Gabiit	X;IN:ROOT;IN:3.II;OUT:ROOT;OUT:SX
doGot_saGaytGoodint	guut	X;IN:ROOT;IN:PL;IN:TR;IN:3.II;OUT:ROOT;OUT:3.II
doGot_dildilsdiit	doKdiit	X;IN:ROOT;IN:PL;IN:TR;IN:3.II;OUT:ROOT;OUT:PL;OUT:3PL.II
dibakwdiit_siwen	dibekw	X;IN:ROOT;IN:PL;IN:3PL.II;OUT:ROOT;OUT:PL
hidint_'nu'wdiit	hedindiit	X;IN:ROOT;IN:3.II;OUT:ROOT;OUT:3PL.II
saksit_aaKt	daa'wihlt	X;IN:ROOT;IN:PL;IN:SX;OUT:ROOT;OUT:3.II
daa'whldiit_baX-seksdiit	seksdiit	X;IN:ROOT;IN:3PL.II;OUT:ROOT;OUT:PL;OUT:3PL.II
halaakwdiit_hlXo'odiit	wilaakwdiit	X;IN:ROOT;IN:3PL.II;OUT:ROOT;OUT:3PL.II
japdiit_Goyp'aXt	jept	X;IN:ROOT;IN:3PL.II;OUT:ROOT;OUT:3.II
joKdiit_gigitxsit	jaXjoGot	X;IN:ROOT;IN:3PL.II;OUT:ROOT;OUT:PL;OUT:SX
jabit_xsididaa'whlt	jept	X;IN:ROOT;IN:TR;IN:3.II;OUT:ROOT;OUT:3.II
ayukwsi'm_dulbint	ayukwst	X;IN:ROOT;IN:1PL.II;OUT:ROOT;OUT:3.II
gup_hooyi'm	gubi'm	X;IN:ROOT;OUT:ROOT;OUT:TR;OUT:1PL.II
wilpdiit_an'ixwt	wilpt	X;IN:ROOT;IN:3PL.II;OUT:ROOT;OUT:3.II
yuwi'y_hooyit	yuxwit	X;IN:ROOT;IN:TR;IN:1SG.II;OUT:ROOT;OUT:TR;OUT:3.II
t'ehldiit_niiniks	t'ahl	X;IN:ROOT;IN:PL;IN:3PL.II;OUT:ROOT;OUT:PL
helt_ksi'wadiit	heltdiit	X;IN:ROOT;OUT:ROOT;OUT:3PL.II
saGaytwendiit_saGaytwenda	saGaytwenda	X;IN:ROOT;IN:PL;IN:3PL.II;OUT:ROOT;OUT:PL;OUT:3PL
simgiget_doK	simgigat	X;IN:ROOT;IN:PL;OUT:ROOT;OUT:PL
jebi'y_dildilsdiit	jipjepdiit	X;IN:ROOT;IN:TR;IN:1SG.II;OUT:ROOT;OUT:PL;OUT:3PL.II
hishalaagaX_gigiinuxwdiit	ts'ehlXdiit	X;IN:ROOT;IN:PL;OUT:ROOT;OUT:3PL.II
jaXjoGat_am'amit	jaXjoGot	X;IN:ROOT;IN:PL;IN:SX;OUT:ROOT;OUT:PL;OUT:SX
Galhuksindiit_mesxw	??tK'alhuksin	X;IN:ROOT;IN:3PL.II;OUT:ROOT
Galts'epdiit_ga'a'y	Galts'ebi'y	X;IN:ROOT;IN:3PL.II;OUT:ROOT;OUT:1SG.II
wen_mas'usi'm	wani'm	X;IN:ROOT;IN:PL;OUT:ROOT;OUT:PL;OUT:1PL.II
bagu'm_anbisxwit	'witxwit	X;IN:ROOT;IN:PL;IN:1PL.II;OUT:ROOT;OUT:SX
daha'wt_sa'anjapdiit	daha'wdiit	X;IN:ROOT;IN:3.II;OUT:ROOT;OUT:3PL.II
want_dildilsdiit	wendiit	X;IN:ROOT;IN:PL;IN:SX;OUT:ROOT;OUT:PL;OUT:3PL.II
Galts'epdiit_da'aKhlxwi'y	Galts'ebi'y	X;IN:ROOT;IN:3PL.II;OUT:ROOT;OUT:1SG.II
t'aam_mis'usi'm	wani'm	X;IN:ROOT;IN:ATTR;OUT:ROOT;OUT:PL;OUT:1PL.II
Golt_k'ap	baX	X;IN:ROOT;IN:PL;IN:3.II;OUT:ROOT
hoo_algaXdiit	hooxdiit	X;IN:ROOT;OUT:ROOT;OUT:3PL.II
t'ilXo'odiit_baXa'y	t'ilXoo'y	X;IN:ROOT;IN:3PL.II;OUT:ROOT;OUT:1SG.II
wendiit_loGa	t'aam	X;IN:ROOT;IN:PL;IN:3PL.II;OUT:ROOT;OUT:ATTR
'wii_siwen	'waat'aX	X;IN:ROOT;OUT:ROOT;OUT:PL
ga'a_hahle'lst	ga'at	X;IN:ROOT;OUT:ROOT;OUT:3.II
hlo'o'm_ha'niijoKt	yeet	X;IN:ROOT;IN:PL;IN:1PL.II;OUT:ROOT;OUT:3.II
mas'usi'm_sise'en	mihas'usin	X;IN:ROOT;IN:PL;IN:1PL.II;OUT:ROOT;OUT:PL;OUT:2SG.II
hlo'ot_luut'ehldiit	hlo'odiit	X;IN:ROOT;IN:PL;IN:SX;OUT:ROOT;OUT:PL;OUT:3PL.II
lim_Gaseexwt	limxt	X;IN:ROOT;OUT:ROOT;OUT:3.II
jehlit_aaK	jehl	X;IN:ROOT;IN:TR;IN:3.II;OUT:ROOT
huudindiit_doGo'm	huudini'm	X;IN:ROOT;IN:PL;IN:3PL.II;OUT:ROOT;OUT:PL;OUT:TR;OUT:1PL.II
'wii_hap	'wiidaX	X;IN:ROOT;OUT:ROOT;OUT:PL
gupdiit_xsiga'at	gubit	X;IN:ROOT;IN:3PL.II;OUT:ROOT;OUT:TR;OUT:3.II
saGaytGoodain_Gabidiit	saGaytGoodindiit	X;IN:ROOT;OUT:ROOT;OUT:3PL.II
'wadiit_hlimoo'ltt	'wat	X;IN:ROOT;IN:3PL.II;OUT:ROOT;OUT:3.II
wilt_heltda	wilda	X;IN:ROOT;IN:3.II;OUT:ROOT;OUT:3PL
daa'whl_lidindiit	seksdiit	X;IN:ROOT;OUT:ROOT;OUT:PL;OUT:3PL.II
yeet_dohot	hlo'ot	X;IN:ROOT;IN:3.II;OUT:ROOT;OUT:PL;OUT:SX
ts'ehlXdiit_t'e	ts'ehlX	X;IN:ROOT;IN:3PL.II;OUT:ROOT
daXgat_t'aam	daXgadim	X;IN:ROOT;OUT:ROOT;OUT:ATTR
'niiluxw_ehldit'aat	'negwit	X;IN:ROOT;IN:PL;OUT:ROOT;OUT:SX
hogaXam_Ge'ndiit	hogaXdiit	X;IN:ROOT;IN:ATTR;OUT:ROOT;OUT:3PL.II
went_jayeehlt	t'aat	X;IN:ROOT;IN:PL;IN:SX;OUT:ROOT;OUT:3.II
dexwit_weli	'nu'w	X;IN:ROOT;IN:PL;IN:SX;OUT:ROOT
'witxwt_Galjipts'ep	bakw	X;IN:ROOT;IN:3.II;OUT:ROOT;OUT:PL
Goodin_Gost	Goott	X;IN:ROOT;IN:2SG.II;OUT:ROOT;OUT:3.II
guseeK_guseeGat	guseeGat	X;IN:ROOT;OUT:ROOT;OUT:TR;OUT:3.II
wet_jiksindiit	wadiit	X;IN:ROOT;IN:3.II;OUT:ROOT;OUT:3PL.II
seks_'wat	daa'wihlt	X;IN:ROOT;IN:PL;OUT:ROOT;OUT:3.II
sgi_lixleyit	dohot	X;IN:ROOT;OUT:ROOT;OUT:PL;OUT:SX
Gabit_t'amdiit	Gabidiit	X;IN:ROOT;IN:SX;OUT:ROOT;OUT:3PL.II
wat_hisyetst	huwat	X;IN:ROOT;IN:SX;OUT:ROOT;OUT:PL;OUT:3.II
hilendiit_Xmaa'y	hilen	X;IN:ROOT;IN:3PL.II;OUT:ROOT
hloXs_'nekwt	hloXst	X;IN:ROOT;OUT:ROOT;OUT:3.II
saks_lit	seks	X;IN:ROOT;IN:PL;OUT:ROOT;OUT:PL
guxwt_kw'esin	guxw	X;IN:ROOT;IN:3.II;OUT:ROOT
anooKdiit_gwelgwaX	anooK	X;IN:ROOT;IN:3PL.II;OUT:ROOT
wiyitsxwdiit_ayawaatxwdiit	wiyitxwdiit	X;IN:ROOT;IN:3PL.II;OUT:ROOT;OUT:3PL.II
gedi'y_mo'on	get	X;IN:ROOT;IN:1SG.II;OUT:ROOT
daa'whl_wildigitxwit	daa'whlit	X;IN:ROOT;OUT:ROOT;OUT:SX
dast_t'amdiit	desdiit	X;IN:ROOT;IN:3.II;OUT:ROOT;OUT:3PL.II
doKdiit_jaXjoKt	doKt	X;IN:ROOT;IN:PL;IN:3PL.II;OUT:ROOT;OUT:PL;OUT:3.II
naX'nit_ha'widint	naX'nit	X;IN:ROOT;IN:3.II;OUT:ROOT;OUT:3.II
he'y_t'aan	hen	X;IN:ROOT;IN:1SG.II;OUT:ROOT;OUT:2SG.II
gigiinuxwin_t'ilXo'odiit	gigiinuxwdiit	X;IN:ROOT;IN:2SG.II;OUT:ROOT;OUT:3PL.II
doGo'm_laXlaK	doK	X;IN:ROOT;IN:PL;IN:TR;IN:1PL.II;OUT:ROOT;OUT:PL
aluut'aat_do'ot	aluut'aat	X;IN:ROOT;IN:3.II;OUT:ROOT;OUT:3.II
didelKdiit_K'ay'mes	didalK	X;IN:ROOT;IN:3PL.II;OUT:ROOT
da'aKhlxwi'y_gwilan	da'aKhlxwin	X;IN:ROOT;IN:1SG.II;OUT:ROOT;OUT:2SG.II
woK_jiipt	woKt	X;IN:ROOT;OUT:ROOT;OUT:3.II
baXyuxwdiithl_'nii'wa	baXyuxw	X;IN:ROOT;IN:3PL.II;OUT:ROOT
hooxdiit_ga'at	hooyit	X;IN:ROOT;IN:3PL.II;OUT:ROOT;OUT:TR;OUT:3.II
baXt_hlgi	Gol	X;IN:ROOT;IN:3.II;OUT:ROOT;OUT:PL
Galjipts'ep_jiip	Galts'ep	X;IN:ROOT;IN:PL;OUT:ROOT
laahl_aliisxu'm	laahli'm	X;IN:ROOT;IN:PL;OUT:ROOT;OUT:PL;OUT:1PL.II
wanit_'man	t'aa	X;IN:ROOT;IN:PL;IN:SX;OUT:ROOT
joK_office'y	joGo'y	X;IN:ROOT;OUT:ROOT;OUT:1SG.II
dohot_anbisxw	sgi	X;IN:ROOT;IN:PL;IN:SX;OUT:ROOT
went_mis'usi'm	wani'm	X;IN:ROOT;IN:PL;IN:3.II;OUT:ROOT;OUT:PL;OUT:1PL.II
ma'us_mas'usi'm	mas'usi'm	X;IN:ROOT;OUT:ROOT;OUT:PL;OUT:1PL.II
jepdiit_ansdo'ot	japt	X;IN:ROOT;IN:3PL.II;OUT:ROOT;OUT:3.II
gitga'adiit_gyuksint	ga'at	X;IN:ROOT;IN:PL;IN:3PL.II;OUT:ROOT;OUT:TR;OUT:3.II
hugwaXt_t'aham	hugwaGam	X;IN:ROOT;IN:3.II;OUT:ROOT;OUT:ATTR
hahle'lst_hligwi	hahle'lst	X;IN:ROOT;IN:3.II;OUT:ROOT
yuwit_da'witxwit	yuxwit	X;IN:ROOT;IN:TR;IN:3.II;OUT:ROOT;OUT:TR;OUT:3.II
waatxwt_baXin	waatxw	X;IN:ROOT;IN:3.II;OUT:ROOT
t'aat_t'aat	t'aat	X;IN:ROOT;IN:3.II;OUT:ROOT;OUT:SX
xsaxwt_Galjipts'ep	xseeK	X;IN:ROOT;IN:3.II;OUT:ROOT;OUT:PL
miin_gwelk'ujaXt	miint	X;IN:ROOT;OUT:ROOT;OUT:3.II
ayawaatxw_sisatxwdiit	ayawaatxwdiit	X;IN:ROOT;OUT:ROOT;OUT:3PL.II
hahle'lst_t'isit	hahle'lsit	X;IN:ROOT;IN:3.II;OUT:ROOT;OUT:SX
Gol_Goli'm	Goli'm	X;IN:ROOT;IN:PL;OUT:ROOT;OUT:PL;OUT:1PL.II
hoo_ga'a'm	hooyi'm	X;IN:ROOT;OUT:ROOT;OUT:TR;OUT:1PL.II
joGot_hal'olaXat	jaXjoGat	X;IN:ROOT;IN:SX;OUT:ROOT;OUT:PL;OUT:SX
'nu'wit_ant'aahl	'nu'w	X;IN:ROOT;IN:SX;OUT:ROOT
GaGoott_hahle'lsdiit	Gootdiit	X;IN:ROOT;IN:PL;IN:3.II;OUT:ROOT;OUT:3PL.II
want_mis'usi'm	weni'm	X;IN:ROOT;IN:PL;IN:SX;OUT:ROOT;OUT:PL;OUT:1PL.II
jept_suuhlo'odiit	japdiit	X;IN:ROOT;IN:3.II;OUT:ROOT;OUT:3PL.II
wiyitxwdiit_yuxwt	wiyitxwt	X;IN:ROOT;IN:3PL.II;OUT:ROOT;OUT:3.II
giihlt_luut'ehldiit	laahldiit	X;IN:ROOT;IN:3.II;OUT:ROOT;OUT:PL;OUT:3PL.II
helt_t'ihlxum	heldim	X;IN:ROOT;OUT:ROOT;OUT:ATTR
seks_guxw	daa'whl	X;IN:ROOT;IN:PL;OUT:ROOT
wil_huksin	win	X;IN:ROOT;OUT:ROOT;OUT:2SG.II
dibegwit_'nii'wadiit	di'witxwdiit	X;IN:ROOT;IN:PL;IN:TR;IN:3.II;OUT:ROOT;OUT:3PL.II
Goott_k'eeGani'm	Goodi'm	X;IN:ROOT;IN:3.II;OUT:ROOT;OUT:1PL.II
t'e_ma'usi'y	t'agi'y	X;IN:ROOT;OUT:ROOT;OUT:1SG.II
waatxw_gupdiit	waatxwdiit	X;IN:ROOT;OUT:ROOT;OUT:3PL.II
noXdiit_hen	noXon	X;IN:ROOT;IN:3PL.II;OUT:ROOT;OUT:2SG.II
'alGal_GatGoodindiit	al'alGaldiit	X;IN:ROOT;OUT:ROOT;OUT:PL;OUT:3PL.II
hlguts'uusgi'm_men	hlguts'uus	X;IN:ROOT;IN:1PL.II;OUT:ROOT
t'amin_'wits'indiit	t'amdiit	X;IN:ROOT;IN:TR;IN:2SG.II;OUT:ROOT;OUT:3PL.II
yeet_luuwent	hlo'ot	X;IN:ROOT;IN:3.II;OUT:ROOT;OUT:PL;OUT:3.II
bagu'm_luuwent	bekwt	X;IN:ROOT;IN:PL;IN:1PL.II;OUT:ROOT;OUT:PL;OUT:3.II
'witxwit_mas'usi'm	begu'm	X;IN:ROOT;IN:SX;OUT:ROOT;OUT:PL;OUT:1PL.II
GaGootdiit_ha'niijoGa'm	Goodi'm	X;IN:ROOT;IN:PL;IN:3PL.II;OUT:ROOT;OUT:1PL.II
yeet_bahlXin	yee	X;IN:ROOT;IN:SX;OUT:ROOT
hlgim_yee'y	hlguuhlxwi'y	X;IN:ROOT;IN:PL;IN:ATTR;OUT:ROOT;OUT:1SG.II
ga'at_t'ihlxw	ga'a	X;IN:ROOT;IN:3.II;OUT:ROOT
dew_daXgett	dawt	X;IN:ROOT;OUT:ROOT;OUT:3.II
ehldit'aat_mihl	ehldit'aa	X;IN:ROOT;IN:SX;OUT:ROOT
'maXst_t'ipXaat	'maXs	X;IN:ROOT;IN:3.II;OUT:ROOT
tK'esxwt_gubit	tK'esxwit	X;IN:ROOT;IN:3.II;OUT:ROOT;OUT:TR;OUT:3.II
yee_da'aKhlxwi'y	yee'y	X;IN:ROOT;OUT:ROOT;OUT:1SG.II
Galts'ebi'y_huwilaa	Galjipts'ep	X;IN:ROOT;IN:1SG.II;OUT:ROOT;OUT:PL
doGot_wilplaahlt	doKt	X;IN:ROOT;IN:PL;IN:TR;IN:3.II;OUT:ROOT;OUT:PL;OUT:3.II
hap_hlgidiit	hapdiit	X;IN:ROOT;IN:PL;OUT:ROOT;OUT:PL;OUT:3PL.II
hugwaXt_Go'odiit	hogaXdiit	X;IN:ROOT;IN:3.II;OUT:ROOT;OUT:3PL.II
noXa'y_K'aKt	noXt	X;IN:ROOT;IN:1SG.II;OUT:ROOT;OUT:3.II
joK_liiluxwdiit	jaXjoKdiit	X;IN:ROOT;OUT:ROOT;OUT:PL;OUT:3PL.II
sme_sGat'akwt	smaxt	X;IN:ROOT;OUT:ROOT;OUT:3.II
da'witxwit_sa'anjoK	dikw'itxw	X;IN:ROOT;IN:TR;IN:3.II;OUT:ROOT
dibekwt_Gol	dibekw	X;IN:ROOT;IN:PL;IN:3.II;OUT:ROOT;OUT:PL
loK_ts'ept	loKt	X;IN:ROOT;OUT:ROOT;OUT:3.II
sekst_jaXjoGat	seksit	X;IN:ROOT;IN:PL;IN:3.II;OUT:ROOT;OUT:PL;OUT:SX
woK'_hlist	woK't	X;IN:ROOT;OUT:ROOT;OUT:3.II
t'aam_dildilsit	want	X;IN:ROOT;IN:ATTR;OUT:ROOT;OUT:PL;OUT:SX
yuxwit_maGoont	yuxwt	X;IN:ROOT;IN:TR;IN:3.II;OUT:ROOT;OUT:3.II
di'witxwdiit_doKt	dibekwt	X;IN:ROOT;IN:3PL.II;OUT:ROOT;OUT:PL;OUT:3.II
gwiiseeK_hogaXat	guseeGat	X;IN:ROOT;IN:PL;OUT:ROOT;OUT:TR;OUT:3.II
limXs_ayukwst	'mast	X;IN:ROOT;IN:PL;OUT:ROOT;OUT:3.II
huwelixim_pdelt	welixt	X;IN:ROOT;IN:PL;IN:ATTR;OUT:ROOT;OUT:3.II
lixsgadim_betl'a	lixsgadim	X;IN:ROOT;IN:ATTR;OUT:ROOT;OUT:ATTR
yuxwt_daha'wdiit	yuxwdiit	X;IN:ROOT;IN:3.II;OUT:ROOT;OUT:3PL.II
Galts'ebi'm_sGat'aat	Galts'ept	X;IN:ROOT;IN:1PL.II;OUT:ROOT;OUT:3.II
loodiit_Galjipts'ep	loo	X;IN:ROOT;IN:PL;IN:3PL.II;OUT:ROOT;OUT:PL
ga'at_nooGa'y	ga'a'y	X;IN:ROOT;IN:TR;IN:3.II;OUT:ROOT;OUT:1SG.II
heltdiit_GasGoot	heldit	X;IN:ROOT;IN:3PL.II;OUT:ROOT;OUT:SX
t'imGes_japt	t'imGest	X;IN:ROOT;OUT:ROOT;OUT:3.II
joKdiit_gwila'm	joGo'm	X;IN:ROOT;IN:3PL.II;OUT:ROOT;OUT:1PL.II
wiyitsxwdiit_ha'niijoKt	wiyitxwt	X;IN:ROOT;IN:3PL.II;OUT:ROOT;OUT:3.II
'witxw_niiniks	bakw	X;IN:ROOT;OUT:ROOT;OUT:PL
Gabidiit_'witxwit	Gabiit	X;IN:ROOT;IN:3PL.II;OUT:ROOT;OUT:SX
noXt_'nii'wadiit	noXdiit	X;IN:ROOT;IN:3.II;OUT:ROOT;OUT:3PL.II
huutt_bagu'm	huudi'm	X;IN:ROOT;IN:PL;IN:3.II;OUT:ROOT;OUT:PL;OUT:1PL.II
nigwoott_Gani'm	nigwoodi'm	X;IN:ROOT;IN:3.II;OUT:ROOT;OUT:1PL.II
wisi'm_wilsi'm	wilsi'm	X;IN:ROOT;IN:2PL.II;OUT:ROOT;OUT:2PL.II
ha'wi'm_hahla'lsdi'm	ha'u'm	X;IN:ROOT;IN:1PL.II;OUT:ROOT;OUT:1PL.II
Goodin_doXdiit	GaGootdiit	X;IN:ROOT;IN:2SG.II;OUT:ROOT;OUT:PL;OUT:3PL.II
dexwit_nigwoott	'nu'wt	X;IN:ROOT;IN:PL;IN:SX;OUT:ROOT;OUT:3.II
da'aKhlxwdiit_gigiinuxwin	da'aKhlxwin	X;IN:ROOT;IN:3PL.II;OUT:ROOT;OUT:2SG.II
halaaxt_hlguuhlxw	halaa	X;IN:ROOT;IN:3.II;OUT:ROOT
t'ilXoo_t'agi'y	t'ilXoo'y	X;IN:ROOT;OUT:ROOT;OUT:1SG.II
joGo'y_gwiiseeKt	jaXjoKt	X;IN:ROOT;IN:1SG.II;OUT:ROOT;OUT:PL;OUT:3.II
dewdew_yukwsin	dew	X;IN:ROOT;IN:PL;OUT:ROOT
maKt_sdo'oks	maK	X;IN:ROOT;IN:3.II;OUT:ROOT
Gabiit_gindiit	Gabidiit	X;IN:ROOT;IN:3.II;OUT:ROOT;OUT:3PL.II
gupt_ga'at	gubit	X;IN:ROOT;IN:3.II;OUT:ROOT;OUT:TR;OUT:3.II
'witxw_t'agi'y	'witxwi'y	X;IN:ROOT;OUT:ROOT;OUT:1SG.II
xsawi'y_Gol	xseeK	X;IN:ROOT;IN:1SG.II;OUT:ROOT;OUT:PL
hiji'm_doGot	hashejit	X;IN:ROOT;IN:1PL.II;OUT:ROOT;OUT:PL;OUT:TR;OUT:3.II
joGot_aliisxu'm	jaXjoGo'm	X;IN:ROOT;IN:SX;OUT:ROOT;OUT:PL;OUT:1PL.II
laXyipdiit_luujoGat	laXyibit	X;IN:ROOT;IN:3PL.II;OUT:ROOT;OUT:SX
wendiit_hal'algaXt	want	X;IN:ROOT;IN:PL;IN:3PL.II;OUT:ROOT;OUT:PL;OUT:3.II
Goot_Goodin	Goodin	X;IN:ROOT;OUT:ROOT;OUT:2SG.II
hanaK'a'y_k'utk'udaaxt	hanaK't	X;IN:ROOT;IN:1SG.II;OUT:ROOT;OUT:3.II
mas'usi'm_ha'niilaahl	mihas'us	X;IN:ROOT;IN:PL;IN:1PL.II;OUT:ROOT;OUT:PL
ga'a'y_hlguuhlxwi'y	ga'a'y	X;IN:ROOT;IN:TR;IN:1SG.II;OUT:ROOT;OUT:1SG.II
ha'wi'y_wili'm	ha'wi'm	X;IN:ROOT;IN:1SG.II;OUT:ROOT;OUT:1PL.II
hahle'lsdi'm_guslisdiit	hahle'lstdiit	X;IN:ROOT;IN:1PL.II;OUT:ROOT;OUT:3PL.II
want_baGadilt	t'aat	X;IN:ROOT;IN:PL;IN:SX;OUT:ROOT;OUT:SX
hooyi'y_ts'uuts't	hooxt	X;IN:ROOT;IN:TR;IN:1SG.II;OUT:ROOT;OUT:3.II
noXt_anooGo'm	noXo'm	X;IN:ROOT;IN:3.II;OUT:ROOT;OUT:1PL.II
lixsgat_daXgadim	lixsgadim	X;IN:ROOT;OUT:ROOT;OUT:ATTR
limXs_'masi'y	'masi'y	X;IN:ROOT;IN:PL;OUT:ROOT;OUT:1SG.II
hahle'lsit_tXalpXat	hahla'ljit	X;IN:ROOT;IN:SX;OUT:ROOT;OUT:SX
'witxwt_hithit't	bekwt	X;IN:ROOT;IN:3.II;OUT:ROOT;OUT:PL;OUT:3.II
hlguuhlxw_t'agi'y	hlguuhlxwi'y	X;IN:ROOT;OUT:ROOT;OUT:1SG.II
sgit_huwilpt	doXt	X;IN:ROOT;IN:SX;OUT:ROOT;OUT:PL;OUT:3.II
t'aat_hapdiit	wandiit	X;IN:ROOT;IN:SX;OUT:ROOT;OUT:PL;OUT:3PL.II
alGalt_hlaahlaXtt	al'alGalt	X;IN:ROOT;IN:3.II;OUT:ROOT;OUT:PL;OUT:3.II
t'agi'y_'weesxwt	t'ekt	X;IN:ROOT;IN:TR;IN:1SG.II;OUT:ROOT;OUT:3.II
noXo'm_ts'uusgi'y	noXo'y	X;IN:ROOT;IN:1PL.II;OUT:ROOT;OUT:1SG.II
daa'whldiit_hahlo'o	saks	X;IN:ROOT;IN:3PL.II;OUT:ROOT;OUT:PL
silimxdiit_Xsdaadiit	salimxdiit	X;IN:ROOT;IN:3PL.II;OUT:ROOT;OUT:3PL.II
noXa'y_jemdiit	noXdiit	X;IN:ROOT;IN:1SG.II;OUT:ROOT;OUT:3PL.II
dibekwt_saksdiit	dibakwdiit	X;IN:ROOT;IN:PL;IN:3.II;OUT:ROOT;OUT:PL;OUT:3PL.II
anooKt_xsididaa'whl	anooK	X;IN:ROOT;IN:3.II;OUT:ROOT
Gabiit_'mits'in	Gabii	X;IN:ROOT;IN:3.II;OUT:ROOT
saGaytGootdiit_baGadilda	saGaytGootda	X;IN:ROOT;IN:3PL.II;OUT:ROOT;OUT:3PL
gwelgwa_eejam	gwalgwa	X;IN:ROOT;IN:ATTR;OUT:ROOT;OUT:ATTR
baGa'm_toosdiit	baKdiit	X;IN:ROOT;IN:TR;IN:1PL.II;OUT:ROOT;OUT:3PL.II
sdik'eekwt_Goodin	sdik'eegwin	X;IN:ROOT;IN:3.II;OUT:ROOT;OUT:2SG.II
yets_ayukwst	yetst	X;IN:ROOT;OUT:ROOT;OUT:3.II
ts'epdiit_'nii'wa	ts'ep	X;IN:ROOT;IN:3PL.II;OUT:ROOT
woK't_wilp	woK'	X;IN:ROOT;IN:3.II;OUT:ROOT
ky'ult_hooyindiit	ky'uldiit	X;IN:ROOT;IN:SX;OUT:ROOT;OUT:3PL.II
baas_hooxdiit	baasxdiit	X;IN:ROOT;OUT:ROOT;OUT:3PL.II
Galts'epdiit_nigwoott	Galts'ept	X;IN:ROOT;IN:3PL.II;OUT:ROOT;OUT:3.II
hugwaX_XsdemGam	hogaXam	X;IN:ROOT;OUT:ROOT;OUT:ATTR
nibip_guts'uusgi'm	nibibi'm	X;IN:ROOT;OUT:ROOT;OUT:1PL.II
went_baGadilim	t'aam	X;IN:ROOT;IN:PL;IN:SX;OUT:ROOT;OUT:ATTR
huwat_simihldiit	wadiit	X;IN:ROOT;IN:PL;IN:3.II;OUT:ROOT;OUT:3PL.II
dohot_xsididaa'whlt	sgit	X;IN:ROOT;IN:PL;IN:SX;OUT:ROOT;OUT:3.II
Gol_ayawaatxwt	baXt	X;IN:ROOT;IN:PL;OUT:ROOT;OUT:3.II
huwat_hasbagyoot	wat	X;IN:ROOT;IN:PL;IN:3.II;OUT:ROOT;OUT:3.II
wet_aX'algaGa'y	we'y	X;IN:ROOT;IN:3.II;OUT:ROOT;OUT:1SG.II
saalukwdiit_aKhlxw	saalukw	X;IN:ROOT;IN:3PL.II;OUT:ROOT
am'amit_andabim	ama	X;IN:ROOT;IN:PL;IN:SX;OUT:ROOT;OUT:ATTR
Gootdiit_wilplaahlt	GaGoott	X;IN:ROOT;IN:3PL.II;OUT:ROOT;OUT:PL;OUT:3.II
ama_heet	aamit	X;IN:ROOT;IN:ATTR;OUT:ROOT;OUT:SX
naX'nit_diha'w	naX'ni	X;IN:ROOT;IN:3.II;OUT:ROOT
Galts'epdiit_hlimoo	Galts'ap	X;IN:ROOT;IN:3PL.II;OUT:ROOT
wilt_Go'osi'm	wilsi'm	X;IN:ROOT;IN:SX;OUT:ROOT;OUT:2PL.II
xsaxw_mail'y	xsawi'y	X;IN:ROOT;OUT:ROOT;OUT:1SG.II
alGalt_saksdiit	al'alGaldiit	X;IN:ROOT;IN:3.II;OUT:ROOT;OUT:PL;OUT:3PL.II
jaXjoGat_t'aat	joGot	X;IN:ROOT;IN:PL;IN:SX;OUT:ROOT;OUT:SX
wen_laXyibit	t'aat	X;IN:ROOT;IN:PL;OUT:ROOT;OUT:SX
went_gitga'adiit	wandiit	X;IN:ROOT;IN:PL;IN:SX;OUT:ROOT;OUT:PL;OUT:3PL.II
doGo'm_gwiiseeKt	doKt	X;IN:ROOT;IN:PL;IN:TR;IN:1PL.II;OUT:ROOT;OUT:PL;OUT:3.II
pole_ha'niijoGa'm	Gani'm	X;IN:ROOT;OUT:ROOT;OUT:1PL.II
'mesi'y_wilksisxum	'mesim	X;IN:ROOT;IN:1SG.II;OUT:ROOT;OUT:ATTR
wani'm_doKdiit	wandiit	X;IN:ROOT;IN:PL;IN:1PL.II;OUT:ROOT;OUT:PL;OUT:3PL.II
alisxu'm_gwiiseeK	aliisxw	X;IN:ROOT;IN:1PL.II;OUT:ROOT;OUT:PL
Xsdaadiit_mahl	Xsdaa	X;IN:ROOT;IN:3PL.II;OUT:ROOT
dibakwdiit_al'alGalt	dibekwt	X;IN:ROOT;IN:PL;IN:3PL.II;OUT:ROOT;OUT:PL;OUT:3.II
wen_t'ayksxw	t'aa	X;IN:ROOT;IN:PL;OUT:ROOT
gigiinuxwdiit_amGoo	gigiinuxw	X;IN:ROOT;IN:3PL.II;OUT:ROOT
gigiinuxwin_Xhluxw	gigiinuxw	X;IN:ROOT;IN:2SG.II;OUT:ROOT
wegi'y_Xhluxwt	wakt	X;IN:ROOT;IN:1SG.II;OUT:ROOT;OUT:3.II
amhalayt_guxwt	amhalaytt	X;IN:ROOT;OUT:ROOT;OUT:3.II
gi'nam_baasxi'y	gi'nami'y	X;IN:ROOT;OUT:ROOT;OUT:TR;OUT:1SG.II
ga'a'm_GaGootdiit	gitga'adiit	X;IN:ROOT;IN:1PL.II;OUT:ROOT;OUT:PL;OUT:3PL.II
'witxwi'y_japt	'witxwt	X;IN:ROOT;IN:1SG.II;OUT:ROOT;OUT:3.II
naX'ni_hilendiit	naX'nidiit	X;IN:ROOT;OUT:ROOT;OUT:3PL.II
anooK_woK't	anooKt	X;IN:ROOT;OUT:ROOT;OUT:3.II
gwelkwt_ts'ee'wa	gwelgwa	X;IN:ROOT;IN:3.II;OUT:ROOT;OUT:ATTR
dawt_hishalaagaX	dewdew	X;IN:ROOT;IN:3.II;OUT:ROOT;OUT:PL
ga'a_baGa'y	ga'a'y	X;IN:ROOT;OUT:ROOT;OUT:TR;OUT:1SG.II
wendiit_saksin	t'aa	X;IN:ROOT;IN:PL;IN:3PL.II;OUT:ROOT
hanaK't_Xa'ni	hanaK'	X;IN:ROOT;IN:3.II;OUT:ROOT
wan_dildilsit	wanit	X;IN:ROOT;IN:PL;OUT:ROOT;OUT:PL;OUT:SX
hogaGam_neksim	hugwaGam	X;IN:ROOT;IN:ATTR;OUT:ROOT;OUT:ATTR
hediit_amgiikw	he	X;IN:ROOT;IN:3PL.II;OUT:ROOT
ama_saksit	am'amit	X;IN:ROOT;IN:ATTR;OUT:ROOT;OUT:PL;OUT:SX
japdiit_jiksindiit	jepdiit	X;IN:ROOT;IN:3PL.II;OUT:ROOT;OUT:3PL.II
yeet_jipjepdiit	hlo'odiit	X;IN:ROOT;IN:3.II;OUT:ROOT;OUT:PL;OUT:3PL.II
kwsdins_xsididaa'whlt	kwsdinst	X;IN:ROOT;OUT:ROOT;OUT:3.II
ga'a'm_mail'y	ga'a'y	X;IN:ROOT;IN:TR;IN:1PL.II;OUT:ROOT;OUT:1SG.II
dildilsit_hasaK	dils	X;IN:ROOT;IN:PL;IN:SX;OUT:ROOT
dexwit_t'uu'wdiit	'nu'wdiit	X;IN:ROOT;IN:PL;IN:SX;OUT:ROOT;OUT:3PL.II
'nakw_baGadilt	'negwit	X;IN:ROOT;OUT:ROOT;OUT:SX
t'ilXoo_aX'algaGa'y	t'ilXoo'y	X;IN:ROOT;OUT:ROOT;OUT:1SG.II
algaX_guts'uusgi'y	algaXa'y	X;IN:ROOT;OUT:ROOT;OUT:1SG.II
am'amt_am'ama	am'ama	X;IN:ROOT;IN:PL;IN:3.II;OUT:ROOT;OUT:PL;OUT:ATTR
joGo'y_k'i'lixsi'm	joGo'm	X;IN:ROOT;IN:1SG.II;OUT:ROOT;OUT:1PL.II
tK'esxw_saks	hap	X;IN:ROOT;OUT:ROOT;OUT:PL
hlimooyi'm_ksi'wa	hlimoo	X;IN:ROOT;IN:TR;IN:1PL.II;OUT:ROOT
want_ha'niilaahl	wen	X;IN:ROOT;IN:PL;IN:SX;OUT:ROOT;OUT:PL
joGat_mis'usi'm	jaXjoGo'm	X;IN:ROOT;IN:SX;OUT:ROOT;OUT:PL;OUT:1PL.II
woK_dewdew	woowaX	X;IN:ROOT;OUT:ROOT;OUT:PL
wet_Xa'naayi'm	wa'm	X;IN:ROOT;IN:3.II;OUT:ROOT;OUT:1PL.II
jept_tK'esxwit	jabit	X;IN:ROOT;IN:3.II;OUT:ROOT;OUT:TR;OUT:3.II
lidint_gup	hitin	X;IN:ROOT;IN:PL;IN:3.II;OUT:ROOT
yuxw_Gan'malat	yuxwt	X;IN:ROOT;OUT:ROOT;OUT:3.II
jipjepdiit_ga'a'y	jebi'y	X;IN:ROOT;IN:PL;IN:3PL.II;OUT:ROOT;OUT:TR;OUT:1SG.II
hlguts'uus_sdili'm	guts'uusgi'm	X;IN:ROOT;OUT:ROOT;OUT:1PL.II
wan_gitga'adiit	wendiit	X;IN:ROOT;IN:PL;OUT:ROOT;OUT:PL;OUT:3PL.II
hlguuhlxwi'y_hlo'odiit	hlgidiit	X;IN:ROOT;IN:1SG.II;OUT:ROOT;OUT:PL;OUT:3PL.II
yeet_huudi'm	hlo'o'm	X;IN:ROOT;IN:3.II;OUT:ROOT;OUT:PL;OUT:1PL.II
heltt_laXyibit	heldit	X;IN:ROOT;IN:3.II;OUT:ROOT;OUT:SX
loGom_miyuxws	loK	X;IN:ROOT;IN:ATTR;OUT:ROOT
diyee_liluxwst	diyeet	X;IN:ROOT;OUT:ROOT;OUT:3.II
bekwt_nibibi'y	'witxwi'y	X;IN:ROOT;IN:PL;IN:3.II;OUT:ROOT;OUT:1SG.II
wat_anooKt	wet	X;IN:ROOT;IN:3.II;OUT:ROOT;OUT:3.II
hanaK't_K'ay'mesi'y	hanaK'a'y	X;IN:ROOT;IN:3.II;OUT:ROOT;OUT:1SG.II
laahl_amt	giihlt	X;IN:ROOT;IN:PL;OUT:ROOT;OUT:3.II
noho'y_'witxwi'y	noXo'y	X;IN:ROOT;IN:1SG.II;OUT:ROOT;OUT:1SG.II
gidaXdiit_hiji'm	gidaXa'm	X;IN:ROOT;IN:3PL.II;OUT:ROOT;OUT:1PL.II
ehldit'aat_anwil	ehldit'aa	X;IN:ROOT;IN:SX;OUT:ROOT
hlgi_am'ama	hlgim	X;IN:ROOT;IN:PL;OUT:ROOT;OUT:PL;OUT:ATTR
huudi'm_al'alGalt	huutt	X;IN:ROOT;IN:PL;IN:1PL.II;OUT:ROOT;OUT:PL;OUT:3.II
ga'a'y_hiji'm	ga'a'm	X;IN:ROOT;IN:TR;IN:1SG.II;OUT:ROOT;OUT:1PL.II
sise'en_'mukwt	se'et	X;IN:ROOT;IN:PL;IN:2SG.II;OUT:ROOT;OUT:3.II
Goodini'm_mitin	Goodain	X;IN:ROOT;IN:1PL.II;OUT:ROOT
yooK_'niiluxw	tXooK	X;IN:ROOT;OUT:ROOT;OUT:PL
hooxdiit_baasxi'y	hooyi'y	X;IN:ROOT;IN:3PL.II;OUT:ROOT;OUT:TR;OUT:1SG.II
hlguuhlxwi'yaa_Galjipts'ep	hlgi	X;IN:ROOT;IN:1SG.II;OUT:ROOT;OUT:PL
liluxwsisi'm_tk'utk'utk'utk'udaa	liluxws	X;IN:ROOT;IN:2PL.II;OUT:ROOT
bakw_ha'niiwan	bekw	X;IN:ROOT;IN:PL;OUT:ROOT;OUT:PL
japt_ga'a'y	jebi'y	X;IN:ROOT;IN:3.II;OUT:ROOT;OUT:TR;OUT:1SG.II
loodiit_sdilt	gyoot	X;IN:ROOT;IN:PL;IN:3PL.II;OUT:ROOT;OUT:3.II
huwat_ts'in	we	X;IN:ROOT;IN:PL;IN:3.II;OUT:ROOT
saGaytwendiit_gigi'ydiit	saGaytwendiit	X;IN:ROOT;IN:PL;IN:3PL.II;OUT:ROOT;OUT:PL;OUT:3PL.II
hlgit_anhahla'lsdi'y	hlguuhlxwi'y	X;IN:ROOT;IN:PL;IN:3.II;OUT:ROOT;OUT:1SG.II
hlguts'uusgi'm_K'ay'mesi'y	hlguts'uusgi'y	X;IN:ROOT;IN:1PL.II;OUT:ROOT;OUT:1SG.II
laahli'm_hishalaagaX	laahl	X;IN:ROOT;IN:PL;IN:1PL.II;OUT:ROOT;OUT:PL
sdilt_hasbagyoo	sdil	X;IN:ROOT;IN:3.II;OUT:ROOT
wani'm_sins	t'aa	X;IN:ROOT;IN:PL;IN:1PL.II;OUT:ROOT
ma'usi'y_siwen	mihas'us	X;IN:ROOT;IN:1SG.II;OUT:ROOT;OUT:PL
joKdiit_luujoGat	joGat	X;IN:ROOT;IN:3PL.II;OUT:ROOT;OUT:SX
'nakw_joGat	'nagwit	X;IN:ROOT;OUT:ROOT;OUT:SX
wilaaxt_gwelXyee'ns	halaa	X;IN:ROOT;IN:3.II;OUT:ROOT
'masi'y_'wii	'mas	X;IN:ROOT;IN:1SG.II;OUT:ROOT
am'ama_ment	aamit	X;IN:ROOT;IN:PL;IN:ATTR;OUT:ROOT;OUT:SX
yeet_hlo'o'm	hlo'o'm	X;IN:ROOT;IN:3.II;OUT:ROOT;OUT:PL;OUT:1PL.II
saksit_bekwdiit	saksdiit	X;IN:ROOT;IN:PL;IN:SX;OUT:ROOT;OUT:PL;OUT:3PL.II
jebisi'm_ga'a'y	jabi'y	X;IN:ROOT;IN:TR;IN:2PL.II;OUT:ROOT;OUT:TR;OUT:1SG.II
gidiidoK_huutt	gidiidoKt	X;IN:ROOT;IN:PL;OUT:ROOT;OUT:PL;OUT:3.II
lixleyit_andabim	laya	X;IN:ROOT;IN:PL;IN:SX;OUT:ROOT;OUT:ATTR
gipaykw_naX'nidiit	gipaykwdiit	X;IN:ROOT;OUT:ROOT;OUT:3PL.II
'wa_hooyi'm	'wayi'm	X;IN:ROOT;OUT:ROOT;OUT:TR;OUT:1PL.II
gidaXt_gwelgwaXa'm	gidaXa'm	X;IN:ROOT;IN:3.II;OUT:ROOT;OUT:1PL.II
gi'nami'y_da'witxwit	gi'namit	X;IN:ROOT;IN:TR;IN:1SG.II;OUT:ROOT;OUT:TR;OUT:3.II
'witxw_sisipt	bekwt	X;IN:ROOT;OUT:ROOT;OUT:PL;OUT:3.II
liluxws_gipaykwdiit	liluxwsdiit	X;IN:ROOT;OUT:ROOT;OUT:3PL.II
joKt_woowaXa'm	jaXjoGo'm	X;IN:ROOT;IN:3.II;OUT:ROOT;OUT:PL;OUT:1PL.II
daa'whl_'niiluxw	seks	X;IN:ROOT;OUT:ROOT;OUT:PL
t'amdiit_sdint	t'amt	X;IN:ROOT;IN:3PL.II;OUT:ROOT;OUT:3.II
t'aan_dohot	want	X;IN:ROOT;IN:2SG.II;OUT:ROOT;OUT:PL;OUT:SX
doK_dexwdiit	doKdiit	X;IN:ROOT;IN:PL;OUT:ROOT;OUT:PL;OUT:3PL.II
baXyuxwdiithl_anhahla'lst	baXyuxw	X;IN:ROOT;IN:3PL.II;OUT:ROOT
daXgett_betl'a	daXgadim	X;IN:ROOT;IN:3.II;OUT:ROOT;OUT:ATTR
hedindiit_liksgetin	hitin	X;IN:ROOT;IN:3PL.II;OUT:ROOT
miindiit_Gaseexwt	miint	X;IN:ROOT;IN:3PL.II;OUT:ROOT;OUT:3.II
Xbits'iixw_office'y	Xpts'ewi'y	X;IN:ROOT;IN:PL;OUT:ROOT;OUT:1SG.II
noXo'y_luuyuxwdiit	noXdiit	X;IN:ROOT;IN:1SG.II;OUT:ROOT;OUT:3PL.II
seksdiit_'alGal	daa'whl	X;IN:ROOT;IN:PL;IN:3PL.II;OUT:ROOT
hlguuhlxwi'yaa_saXdoXdiit	hlgidiit	X;IN:ROOT;IN:1SG.II;OUT:ROOT;OUT:PL;OUT:3PL.II
hlgi_hanaK'a'y	hlguuhlxwi'yaa	X;IN:ROOT;IN:PL;OUT:ROOT;OUT:1SG.II
ga'a'm_gubi'm	ga'a'm	X;IN:ROOT;IN:1PL.II;OUT:ROOT;OUT:TR;OUT:1PL.II
guu_huudini'm	doGo'm	X;IN:ROOT;OUT:ROOT;OUT:PL;OUT:TR;OUT:1PL.II
dohot_sinhunt	sgit	X;IN:ROOT;IN:PL;IN:SX;OUT:ROOT;OUT:SX
halaa_Xhluxwt	wilaaxt	X;IN:ROOT;OUT:ROOT;OUT:3.II
wa'm_gipaykwt	huwat	X;IN:ROOT;IN:1PL.II;OUT:ROOT;OUT:PL;OUT:3.II
waatxwt_gwiladint	waatxwt	X;IN:ROOT;IN:3.II;OUT:ROOT;OUT:3.II
jehlit_k'apt	jat	X;IN:ROOT;IN:TR;IN:3.II;OUT:ROOT;OUT:3.II
jisjahlit_bahlXant	jat	X;IN:ROOT;IN:PL;IN:TR;IN:3.II;OUT:ROOT;OUT:3.II
gidaXdiit_'wayit	gidaXat	X;IN:ROOT;IN:3PL.II;OUT:ROOT;OUT:TR;OUT:3.II
hlguts'uus_ts'ini'y	hlguts'uusgi'y	X;IN:ROOT;OUT:ROOT;OUT:1SG.II
noXo'y_da'aKhlxwi'y	noho'y	X;IN:ROOT;IN:1SG.II;OUT:ROOT;OUT:1SG.II
sgit_am'amit	dohot	X;IN:ROOT;IN:SX;OUT:ROOT;OUT:PL;OUT:SX
doXdiit_baXyuxwdiithl	sgidiit	X;IN:ROOT;IN:PL;IN:3PL.II;OUT:ROOT;OUT:3PL.II
jaXjoGot_wat	joGat	X;IN:ROOT;IN:PL;IN:SX;OUT:ROOT;OUT:SX
t'amt_didalGan	t'amin	X;IN:ROOT;IN:3.II;OUT:ROOT;OUT:TR;OUT:2SG.II
jepdiit_t'amin	jebin	X;IN:ROOT;IN:3PL.II;OUT:ROOT;OUT:TR;OUT:2SG.II
dikw'itxw_dit'aX	dibakw	X;IN:ROOT;OUT:ROOT;OUT:PL
dexwit_hishalaagaXdiit	dexwdiit	X;IN:ROOT;IN:PL;IN:SX;OUT:ROOT;OUT:PL;OUT:3PL.II
sgit_hishalaagaX	doX	X;IN:ROOT;IN:SX;OUT:ROOT;OUT:PL
guseeK_GanGan	gwiiseeK	X;IN:ROOT;OUT:ROOT;OUT:PL
Gootdiit_noho'y	Goodi'y	X;IN:ROOT;IN:3PL.II;OUT:ROOT;OUT:1SG.II
wilda_liluxwsisi'm	wilsi'm	X;IN:ROOT;IN:3PL;OUT:ROOT;OUT:2PL.II
Xpts'ewi'y_aluugiget	Xbits'iixw	X;IN:ROOT;IN:1SG.II;OUT:ROOT;OUT:PL
ts'ep_a'laXt	ts'ept	X;IN:ROOT;OUT:ROOT;OUT:3.II
ha'w_Ganaa'wi'y	ha'wi'y	X;IN:ROOT;OUT:ROOT;OUT:1SG.II
yuxwit_luuyuxw	yuxw	X;IN:ROOT;IN:TR;IN:3.II;OUT:ROOT
aamit_al'alGalt	am'amt	X;IN:ROOT;IN:SX;OUT:ROOT;OUT:PL;OUT:3.II
'mas_gupt	'mast	X;IN:ROOT;OUT:ROOT;OUT:3.II
'nu'wdiit_huwat	dexwt	X;IN:ROOT;IN:3PL.II;OUT:ROOT;OUT:PL;OUT:3.II
wan_t'aan	t'aan	X;IN:ROOT;IN:PL;OUT:ROOT;OUT:2SG.II
wildigitxwit_office	wildigitxw	X;IN:ROOT;IN:SX;OUT:ROOT
seksdiit_ts'atxwt	daa'wihlt	X;IN:ROOT;IN:PL;IN:3PL.II;OUT:ROOT;OUT:3.II
Goot_GaGoott	GaGoott	X;IN:ROOT;OUT:ROOT;OUT:PL;OUT:3.II
hasaGat_a'laXt	hasaKt	X;IN:ROOT;IN:SX;OUT:ROOT;OUT:3.II
daXgigetdiit_saXdoXdiit	daXgigetdiit	X;IN:ROOT;IN:PL;IN:3PL.II;OUT:ROOT;OUT:PL;OUT:3PL.II
heet_sa'anjoKdiit	hediit	X;IN:ROOT;IN:SX;OUT:ROOT;OUT:3PL.II
weni'm_liiluxwdiit	wendiit	X;IN:ROOT;IN:PL;IN:1PL.II;OUT:ROOT;OUT:PL;OUT:3PL.II
hlguuhlxwi'yaa_hlgi'y	hlgi'y	X;IN:ROOT;IN:1SG.II;OUT:ROOT;OUT:PL;OUT:1SG.II
huudindiit_yee'm	k'eeGani'm	X;IN:ROOT;IN:PL;IN:3PL.II;OUT:ROOT;OUT:1PL.II
neksim_niiniks	niinixs	X;IN:ROOT;IN:ATTR;OUT:ROOT;OUT:PL
Galts'ep_lem	Galjipts'ep	X;IN:ROOT;OUT:ROOT;OUT:PL
gupt_anooKdiit	gupdiit	X;IN:ROOT;IN:3.II;OUT:ROOT;OUT:3PL.II
'nekwt_doK	'niiluxw	X;IN:ROOT;IN:3.II;OUT:ROOT;OUT:PL
hooyi'y_yuuhlimXdiit	hooxdiit	X;IN:ROOT;IN:TR;IN:1SG.II;OUT:ROOT;OUT:3PL.II
joGot_gilbilt	joGat	X;IN:ROOT;IN:SX;OUT:ROOT;OUT:SX
dit'aX_hugwaXt	t'aXt	X;IN:ROOT;IN:PL;OUT:ROOT;OUT:3.II
wilt_anooK	wil	X;IN:ROOT;IN:SX;OUT:ROOT
Xa'ni_gwiladint	Xa'nit	X;IN:ROOT;OUT:ROOT;OUT:3.II
hlguuhlxwi'y_am'ama	hlgim	X;IN:ROOT;IN:1SG.II;OUT:ROOT;OUT:PL;OUT:ATTR
t'e_silkwt	t'ekt	X;IN:ROOT;OUT:ROOT;OUT:3.II
jaXjoGo'm_ha'niiwilXsdiit	jaXjoKdiit	X;IN:ROOT;IN:PL;IN:1PL.II;OUT:ROOT;OUT:PL;OUT:3PL.II
Goot_algaXa'y	Goodi'y	X;IN:ROOT;OUT:ROOT;OUT:1SG.II
hloXs_heldim	hloXsa	X;IN:ROOT;OUT:ROOT;OUT:ATTR
Goodi'y_hlooGo'm	Goodi'm	X;IN:ROOT;IN:1SG.II;OUT:ROOT;OUT:1PL.II
am_'nu'wit	aamit	X;IN:ROOT;OUT:ROOT;OUT:SX
maKdiit_miint	maKt	X;IN:ROOT;IN:3PL.II;OUT:ROOT;OUT:3.II
hediit_t'ilXoo'y	he'y	X;IN:ROOT;IN:3PL.II;OUT:ROOT;OUT:1SG.II
liluxws_Go'osi'm	liluxwsisi'm	X;IN:ROOT;OUT:ROOT;OUT:2PL.II
bekwt_bagu'm	begu'm	X;IN:ROOT;IN:PL;IN:3.II;OUT:ROOT;OUT:PL;OUT:1PL.II
noXo'y_t'aan	noXon	X;IN:ROOT;IN:1SG.II;OUT:ROOT;OUT:2SG.II
waatxwdiit_gwelkwt	waatxwt	X;IN:ROOT;IN:3PL.II;OUT:ROOT;OUT:3.II
saabekwdiit_sekst	saabekwt	X;IN:ROOT;IN:PL;IN:3PL.II;OUT:ROOT;OUT:PL;OUT:3.II
t'ilXo'odiit_wilksisxw	t'ilXoo	X;IN:ROOT;IN:3PL.II;OUT:ROOT
t'aat_dexwit	wanit	X;IN:ROOT;IN:SX;OUT:ROOT;OUT:PL;OUT:SX
aat'ikt_haky'o'ot	aat'ikst	X;IN:ROOT;IN:3.II;OUT:ROOT;OUT:3.II
laahli'm_saGaytwendiit	laahldiit	X;IN:ROOT;IN:PL;IN:1PL.II;OUT:ROOT;OUT:PL;OUT:3PL.II
hasaGa'y_anjap	hasaK	X;IN:ROOT;IN:1SG.II;OUT:ROOT
maKdiit_GatGoodindiit	t'ehldiit	X;IN:ROOT;IN:3PL.II;OUT:ROOT;OUT:PL;OUT:3PL.II
wisi'm_hlo'o'm	wili'm	X;IN:ROOT;IN:2PL.II;OUT:ROOT;OUT:1PL.II
wendiit_mas'usi'm	wani'm	X;IN:ROOT;IN:PL;IN:3PL.II;OUT:ROOT;OUT:PL;OUT:1PL.II
gidaXa'm_gubit	gidaXat	X;IN:ROOT;IN:1PL.II;OUT:ROOT;OUT:TR;OUT:3.II
jaXjoKdiit_hahla'ljit	joGat	X;IN:ROOT;IN:PL;IN:3PL.II;OUT:ROOT;OUT:SX
doXdiit_gakst	sgit	X;IN:ROOT;IN:PL;IN:3PL.II;OUT:ROOT;OUT:3.II
guseeGat_??tK'alhuksin	guseeK	X;IN:ROOT;IN:TR;IN:3.II;OUT:ROOT
jaXjoKt_gyookst	joKt	X;IN:ROOT;IN:PL;IN:3.II;OUT:ROOT;OUT:3.II
Goodi'y_sekst	GaGoott	X;IN:ROOT;IN:1SG.II;OUT:ROOT;OUT:PL;OUT:3.II
gwelgwa_bant	gwelkwt	X;IN:ROOT;IN:ATTR;OUT:ROOT;OUT:3.II
sit'aa_sa'anjoKdiit	sit'aadiit	X;IN:ROOT;OUT:ROOT;OUT:3PL.II
gyoot_hlguts'uus	gyoo	X;IN:ROOT;IN:3.II;OUT:ROOT
noho'y_ts'o'oXsdiit	noXdiit	X;IN:ROOT;IN:1SG.II;OUT:ROOT;OUT:3PL.II
Ganaa'wt_Xsdaa	Ganaa'w	X;IN:ROOT;IN:3.II;OUT:ROOT
japt_masxwt	jept	X;IN:ROOT;IN:3.II;OUT:ROOT;OUT:3.II
hasaGa'm_wilsi'm	hasaKsi'm	X;IN:ROOT;IN:1PL.II;OUT:ROOT;OUT:2PL.II
sa'anjoK_etxwdiit	sa'anjoKdiit	X;IN:ROOT;OUT:ROOT;OUT:3PL.II
gidiidoKdiit_lidint	gidiidoKt	X;IN:ROOT;IN:PL;IN:3PL.II;OUT:ROOT;OUT:PL;OUT:3.II
laXyibit_maKt	laXyipt	X;IN:ROOT;IN:SX;OUT:ROOT;OUT:3.II
halaa_huut	huwilaa	X;IN:ROOT;OUT:ROOT;OUT:PL
Ganaa'wi'y_sinhunt	Ganaa'wt	X;IN:ROOT;IN:1SG.II;OUT:ROOT;OUT:3.II
ama_hlgim	am'ama	X;IN:ROOT;IN:ATTR;OUT:ROOT;OUT:PL;OUT:ATTR
sdili'm_anjap	sdil	X;IN:ROOT;IN:1PL.II;OUT:ROOT
Galjipts'ep_silgedi'm	Galts'ebi'm	X;IN:ROOT;IN:PL;OUT:ROOT;OUT:1PL.II
sget_daa'whlt	sgett	X;IN:ROOT;OUT:ROOT;OUT:3.II
saabekwdiit_al'alGalt	saabekwt	X;IN:ROOT;IN:PL;IN:3PL.II;OUT:ROOT;OUT:PL;OUT:3.II
ky'ult_hooxdiit	ky'uldiit	X;IN:ROOT;IN:3.II;OUT:ROOT;OUT:3PL.II
sgi_dibekw	doX	X;IN:ROOT;OUT:ROOT;OUT:PL
'mas_gwiiseeK	limXs	X;IN:ROOT;OUT:ROOT;OUT:PL
Golt_ha'niilaahl	Gol	X;IN:ROOT;IN:PL;IN:3.II;OUT:ROOT;OUT:PL
gwalkw_betl'a	gwalgwa	X;IN:ROOT;OUT:ROOT;OUT:ATTR
daXgadim_hlguuhlxum	daXgadim	X;IN:ROOT;IN:ATTR;OUT:ROOT;OUT:ATTR
hlguts'uusxt_Goodini'm	hlguts'uusgi'm	X;IN:ROOT;IN:3.II;OUT:ROOT;OUT:1PL.II
sinhunt_daa'whl	sinhun	X;IN:ROOT;IN:SX;OUT:ROOT
wilaayi'y_saks	huwilaa	X;IN:ROOT;IN:TR;IN:1SG.II;OUT:ROOT;OUT:PL
heltdiit_hloXsa	helda	X;IN:ROOT;IN:3PL.II;OUT:ROOT;OUT:ATTR
hogaGam_gwiladiit	hogaXdiit	X;IN:ROOT;IN:ATTR;OUT:ROOT;OUT:3PL.II
'wiiyitxwt_tXo'odiit	wiyitsxwdiit	X;IN:ROOT;IN:3.II;OUT:ROOT;OUT:3PL.II
hahle'lsit_k'eeGani'm	hahla'lsdi'm	X;IN:ROOT;IN:SX;OUT:ROOT;OUT:1PL.II
tXalpXat_gwila'm	tXalpXu'm	X;IN:ROOT;IN:SX;OUT:ROOT;OUT:1PL.II
amt_hisyetst	am'amt	X;IN:ROOT;IN:3.II;OUT:ROOT;OUT:PL;OUT:3.II
wil'naat'ehlt_k'eeKin	wil'naat'ehl	X;IN:ROOT;IN:3.II;OUT:ROOT
he'm_hooyin	he	X;IN:ROOT;IN:1PL.II;OUT:ROOT
Gootdiit_hlo'odiit	GaGootdiit	X;IN:ROOT;IN:3PL.II;OUT:ROOT;OUT:PL;OUT:3PL.II
didelKdiit_t'amin	didalGan	X;IN:ROOT;IN:3PL.II;OUT:ROOT;OUT:TR;OUT:2SG.II
wilpt_Ges	wilp	X;IN:ROOT;IN:3.II;OUT:ROOT
joKt_loot	jaXjoKt	X;IN:ROOT;IN:3.II;OUT:ROOT;OUT:PL;OUT:3.II
daa'whldiit_am'amit	saksit	X;IN:ROOT;IN:3PL.II;OUT:ROOT;OUT:PL;OUT:SX
ehldit'aat_ment	ehldit'aat	X;IN:ROOT;IN:SX;OUT:ROOT;OUT:SX
neksim_t'ekt	nekst	X;IN:ROOT;IN:ATTR;OUT:ROOT;OUT:3.II
hugwaGam_saGaytGoodint	hugwaXt	X;IN:ROOT;IN:ATTR;OUT:ROOT;OUT:3.II
noho'y_hen	noXon	X;IN:ROOT;IN:1SG.II;OUT:ROOT;OUT:2SG.II
bekwt_aliisxu'm	begu'm	X;IN:ROOT;IN:PL;IN:3.II;OUT:ROOT;OUT:PL;OUT:1PL.II
huksin_nibibi'y	huksi'y	X;IN:ROOT;IN:2SG.II;OUT:ROOT;OUT:1SG.II
am_am'ama	am'ama	X;IN:ROOT;OUT:ROOT;OUT:PL;OUT:ATTR
hlguts'uusgi'y_Xpts'ewi'y	guts'uusgi'y	X;IN:ROOT;IN:1SG.II;OUT:ROOT;OUT:1SG.II
weni'm_gu	t'aa	X;IN:ROOT;IN:PL;IN:1PL.II;OUT:ROOT
waatxwt_giisdiit	waatxwdiit	X;IN:ROOT;IN:3.II;OUT:ROOT;OUT:3PL.II
dibekw_sbaGaytGanGan	dibakw	X;IN:ROOT;IN:PL;OUT:ROOT;OUT:PL
a'laXa'm_sGat'akwt	a'laXt	X;IN:ROOT;IN:1PL.II;OUT:ROOT;OUT:3.II
het_haboo'l	he	X;IN:ROOT;IN:3.II;OUT:ROOT
hlguuhlxwi'yaa_t'isim	hlguuhlxum	X;IN:ROOT;IN:1SG.II;OUT:ROOT;OUT:ATTR
haanaK'_Gaseexw	hanaK'	X;IN:ROOT;IN:PL;OUT:ROOT
liksgedim_amgiigum	lixsgadim	X;IN:ROOT;IN:ATTR;OUT:ROOT;OUT:ATTR
hahle'lsdi'm_asdint	hahle'lst	X;IN:ROOT;IN:1PL.II;OUT:ROOT;OUT:3.II
jabi'y_diyee	jep	X;IN:ROOT;IN:TR;IN:1SG.II;OUT:ROOT
hlguts'uusgi'm_gwila'm	guts'uusgi'm	X;IN:ROOT;IN:1PL.II;OUT:ROOT;OUT:1PL.II
bagu'm_Xhluxwt	'witxwt	X;IN:ROOT;IN:PL;IN:1PL.II;OUT:ROOT;OUT:3.II
'nu'wt_waaxt	'nu'wt	X;IN:ROOT;IN:SX;OUT:ROOT;OUT:3.II
GatGoodindiit_'mukw	Goodain	X;IN:ROOT;IN:PL;IN:3PL.II;OUT:ROOT
hlimoodiit_kw'oodini'm	hlimooyi'm	X;IN:ROOT;IN:3PL.II;OUT:ROOT;OUT:TR;OUT:1PL.II
sdik'eekw_noXon	sdik'eegwin	X;IN:ROOT;OUT:ROOT;OUT:2SG.II
hlo'odiit_huutt	hlo'ot	X;IN:ROOT;IN:PL;IN:3PL.II;OUT:ROOT;OUT:PL;OUT:3.II
guxw_t'amin	guxwin	X;IN:ROOT;OUT:ROOT;OUT:TR;OUT:2SG.II
guut_jisjahlit	doGot	X;IN:ROOT;IN:3.II;OUT:ROOT;OUT:PL;OUT:TR;OUT:3.II
xsaxw_Galjipts'ep	xseeK	X;IN:ROOT;OUT:ROOT;OUT:PL
wilaayit_Galjipts'ep	huwilaa	X;IN:ROOT;IN:TR;IN:3.II;OUT:ROOT;OUT:PL
wan_wanit	went	X;IN:ROOT;IN:PL;OUT:ROOT;OUT:PL;OUT:SX
win_ga'a'y	wili'y	X;IN:ROOT;IN:2SG.II;OUT:ROOT;OUT:1SG.II
t'ekt_wilaayi'y	t'agi'y	X;IN:ROOT;IN:3.II;OUT:ROOT;OUT:TR;OUT:1SG.II
is_wa'm	isi'm	X;IN:ROOT;OUT:ROOT;OUT:1PL.II
hlimoo'm_gutXa'oot	hlimoot	X;IN:ROOT;IN:1PL.II;OUT:ROOT;OUT:3.II
guseeGat_gidiidoKt	gwiiseeKt	X;IN:ROOT;IN:TR;IN:3.II;OUT:ROOT;OUT:PL;OUT:3.II
want_hlo'ot	went	X;IN:ROOT;IN:PL;IN:SX;OUT:ROOT;OUT:PL;OUT:SX
het_Gani'm	he'm	X;IN:ROOT;IN:3.II;OUT:ROOT;OUT:1PL.II
das_xhliiguut	dast	X;IN:ROOT;OUT:ROOT;OUT:3.II
wanit_'nagwit	t'aat	X;IN:ROOT;IN:PL;IN:SX;OUT:ROOT;OUT:SX
'mesim_office'y	'masi'y	X;IN:ROOT;IN:ATTR;OUT:ROOT;OUT:1SG.II
guts'uusgi'm_Galts'ebi'y	guts'uusgi'y	X;IN:ROOT;IN:1PL.II;OUT:ROOT;OUT:1SG.II
wildiit_hlo'o'm	wili'm	X;IN:ROOT;IN:3PL.II;OUT:ROOT;OUT:1PL.II
sGa'wat_tK'am'u	sGa'wa	X;IN:ROOT;IN:3.II;OUT:ROOT
hahle'lstdiit_ayooKt	hahle'lst	X;IN:ROOT;IN:3PL.II;OUT:ROOT;OUT:3.II
guseeK_gidiidoKt	gwiiseeKt	X;IN:ROOT;OUT:ROOT;OUT:PL;OUT:3.II
wilaayi'y_t'isdiit	halaaxdiit	X;IN:ROOT;IN:TR;IN:1SG.II;OUT:ROOT;OUT:3PL.II
liluxwsdiit_del	liluxws	X;IN:ROOT;IN:3PL.II;OUT:ROOT
hloXst_'mas	hloXs	X;IN:ROOT;IN:3.II;OUT:ROOT
joKt_la	joK	X;IN:ROOT;IN:3.II;OUT:ROOT
bekwt_Xbits'iixw	bekw	X;IN:ROOT;IN:PL;IN:3.II;OUT:ROOT;OUT:PL
bekw_hlaahlaXtt	bekwt	X;IN:ROOT;IN:PL;OUT:ROOT;OUT:PL;OUT:3.II
haanaK'_aX'algaGa'y	hanaK'a'y	X;IN:ROOT;IN:PL;OUT:ROOT;OUT:1SG.II
hal'algaXt_Goodi'y	algaXa'y	X;IN:ROOT;IN:PL;IN:3.II;OUT:ROOT;OUT:1SG.II
wil_hahla'lsdi'y	wili'y	X;IN:ROOT;OUT:ROOT;OUT:1SG.II
laXyip_hedindiit	laXyipdiit	X;IN:ROOT;OUT:ROOT;OUT:3PL.II
hogaXam_tK'a	hugwaX	X;IN:ROOT;IN:ATTR;OUT:ROOT
ha'wt_ts'iip	ha'w	X;IN:ROOT;IN:3.II;OUT:ROOT
ama_ist	amt	X;IN:ROOT;IN:ATTR;OUT:ROOT;OUT:3.II
Galts'ebi'y_limxt	Galts'ept	X;IN:ROOT;IN:1SG.II;OUT:ROOT;OUT:3.II
seksit_saksit	saksit	X;IN:ROOT;IN:PL;IN:SX;OUT:ROOT;OUT:PL;OUT:SX
hapdiit_ayooKt	tK'esxwt	X;IN:ROOT;IN:PL;IN:3PL.II;OUT:ROOT;OUT:3.II
guseeKt_xsa'aKxw	guseeK	X;IN:ROOT;IN:3.II;OUT:ROOT
Goott_nibibi'y	Goodi'y	X;IN:ROOT;IN:3.II;OUT:ROOT;OUT:1SG.II
'nu'w_haXhaaK'ant	dexwt	X;IN:ROOT;OUT:ROOT;OUT:PL;OUT:3.II
huudindiit_guslis	k'eeKin	X;IN:ROOT;IN:PL;IN:3PL.II;OUT:ROOT
ts'ehlXdiit_doXdiit	hishalaagaXdiit	X;IN:ROOT;IN:3PL.II;OUT:ROOT;OUT:PL;OUT:3PL.II
k'uba_Gol	hlk'uba	X;IN:ROOT;IN:PL;OUT:ROOT;OUT:PL
t'aat_al'alGalt	want	X;IN:ROOT;IN:3.II;OUT:ROOT;OUT:PL;OUT:3.II
hogaGam_daXgadim	hogaXam	X;IN:ROOT;IN:ATTR;OUT:ROOT;OUT:ATTR
hogaXam_laya	hugwaGam	X;IN:ROOT;IN:ATTR;OUT:ROOT;OUT:ATTR
isi'm_lekw	is	X;IN:ROOT;IN:1PL.II;OUT:ROOT
aat'ikst_'mootxw	aat'iks	X;IN:ROOT;IN:3.II;OUT:ROOT
sgit_tXooK	doX	X;IN:ROOT;IN:3.II;OUT:ROOT;OUT:PL
t'aan_ama	t'aam	X;IN:ROOT;IN:2SG.II;OUT:ROOT;OUT:ATTR
amhalaytt_jakw	amhalayt	X;IN:ROOT;IN:3.II;OUT:ROOT
weni'm_waatxwit	t'aat	X;IN:ROOT;IN:PL;IN:1PL.II;OUT:ROOT;OUT:SX
joGat_tXooGant	jaXjoKt	X;IN:ROOT;IN:SX;OUT:ROOT;OUT:PL;OUT:3.II
jabit_wilaayisi'm	jebisi'm	X;IN:ROOT;IN:TR;IN:3.II;OUT:ROOT;OUT:TR;OUT:2PL.II
hahle'lstdiit_'nu'wdiit	hahle'lsdiit	X;IN:ROOT;IN:3PL.II;OUT:ROOT;OUT:3PL.II
Galts'ap_gidaXa'm	Galts'ebi'm	X;IN:ROOT;OUT:ROOT;OUT:1PL.II
gupt_wilaayi'y	gubi'y	X;IN:ROOT;IN:3.II;OUT:ROOT;OUT:TR;OUT:1SG.II
dibegwit_Xsiks	dikw'itxw	X;IN:ROOT;IN:PL;IN:TR;IN:3.II;OUT:ROOT
wanit_t'aham	t'aam	X;IN:ROOT;IN:PL;IN:SX;OUT:ROOT;OUT:ATTR
hlimoo_Gosi'm	hlimooyi'm	X;IN:ROOT;OUT:ROOT;OUT:TR;OUT:1PL.II
went_hlo'ot	want	X;IN:ROOT;IN:PL;IN:SX;OUT:ROOT;OUT:PL;OUT:SX
weni'm_hasaGat	t'aat	X;IN:ROOT;IN:PL;IN:1PL.II;OUT:ROOT;OUT:SX
yeet_daXgedi'm	yee'm	X;IN:ROOT;IN:SX;OUT:ROOT;OUT:1PL.II
gedi'y_xhliiguut	gett	X;IN:ROOT;IN:1SG.II;OUT:ROOT;OUT:3.II
daXgedi'm_ayukwsi'm	daXgedi'm	X;IN:ROOT;IN:1PL.II;OUT:ROOT;OUT:1PL.II
gwila_luuwendiit	gwiiladiit	X;IN:ROOT;OUT:ROOT;OUT:PL;OUT:3PL.II
noXon_jiip	noX	X;IN:ROOT;IN:2SG.II;OUT:ROOT
Xsdaat_bitxwit	Xsdaat	X;IN:ROOT;IN:3.II;OUT:ROOT;OUT:SX
anooGo'm_gigeeni	anooK	X;IN:ROOT;IN:1PL.II;OUT:ROOT
jept_t'amin	jebin	X;IN:ROOT;IN:3.II;OUT:ROOT;OUT:TR;OUT:2SG.II
helda_heltda	heltda	X;IN:ROOT;IN:ATTR;OUT:ROOT;OUT:3PL
gipaygum_dibekw	gipaykw	X;IN:ROOT;IN:ATTR;OUT:ROOT;OUT:PL
sGa'wadiit_Galts'epdiit	sGa'wadiit	X;IN:ROOT;IN:3PL.II;OUT:ROOT;OUT:3PL.II
joKt_Gabidiit	joKdiit	X;IN:ROOT;IN:3.II;OUT:ROOT;OUT:3PL.II
t'ilXoo'y_nigwoodi'y	t'ilXoo'y	X;IN:ROOT;IN:1SG.II;OUT:ROOT;OUT:1SG.II
ayawaatxwdiit_ansgi	ayawaatxw	X;IN:ROOT;IN:3PL.II;OUT:ROOT
dibakw_ksi'wa	dikw'itxw	X;IN:ROOT;IN:PL;OUT:ROOT
limxt_sdili'm	limixi'm	X;IN:ROOT;IN:3.II;OUT:ROOT;OUT:1PL.II
wen_lidint	want	X;IN:ROOT;IN:PL;OUT:ROOT;OUT:PL;OUT:3.II
di'witxwdiit_al'alGalt	dibekwt	X;IN:ROOT;IN:3PL.II;OUT:ROOT;OUT:PL;OUT:3.II
didalK_t'amin	didalGan	X;IN:ROOT;OUT:ROOT;OUT:TR;OUT:2SG.II
jat_gimxdi	jehl	X;IN:ROOT;IN:3.II;OUT:ROOT
huudi'm_saahlo'odiit	huutdiit	X;IN:ROOT;IN:PL;IN:1PL.II;OUT:ROOT;OUT:PL;OUT:3PL.II
iwit_hligwi	ixw	X;IN:ROOT;IN:SX;OUT:ROOT
halaaxdiit_pole	halaa	X;IN:ROOT;IN:3PL.II;OUT:ROOT
siwendiit_ts'o'oXs	sit'aa	X;IN:ROOT;IN:PL;IN:3PL.II;OUT:ROOT
sgit_didilsdiit	sgidiit	X;IN:ROOT;IN:SX;OUT:ROOT;OUT:3PL.II
dit'aX_aXalgaX	t'aX	X;IN:ROOT;IN:PL;OUT:ROOT
gup_hediit	gupdiit	X;IN:ROOT;OUT:ROOT;OUT:3PL.II
wilsi'm_wilsi'm	wisi'm	X;IN:ROOT;IN:2PL.II;OUT:ROOT;OUT:2PL.II
joGo'm_aliisxu'm	jaXjoGo'm	X;IN:ROOT;IN:1PL.II;OUT:ROOT;OUT:PL;OUT:1PL.II
seks_luuwendiit	seksdiit	X;IN:ROOT;IN:PL;OUT:ROOT;OUT:PL;OUT:3PL.II
hlo'odiit_sdilt	yeet	X;IN:ROOT;IN:PL;IN:3PL.II;OUT:ROOT;OUT:3.II
japdiit_wilaayisi'm	jebisi'm	X;IN:ROOT;IN:3PL.II;OUT:ROOT;OUT:TR;OUT:2PL.II
sdildiit_dekhl	sdil	X;IN:ROOT;IN:3PL.II;OUT:ROOT
GaGoott_gwilan	Goodin	X;IN:ROOT;IN:PL;IN:3.II;OUT:ROOT;OUT:2SG.II
Xde_ist	xwdaxt	X;IN:ROOT;OUT:ROOT;OUT:3.II
Gabii_'nagwit	Gabit	X;IN:ROOT;OUT:ROOT;OUT:SX
gi'nam_sisatxwdiit	gi'namdiit	X;IN:ROOT;OUT:ROOT;OUT:3PL.II
amhalaytt_XshaneeKt	amhalaytt	X;IN:ROOT;IN:3.II;OUT:ROOT;OUT:3.II
noXon_hlo'o'm	noXo'm	X;IN:ROOT;IN:2SG.II;OUT:ROOT;OUT:1PL.II
want_gidaX	t'aa	X;IN:ROOT;IN:PL;IN:3.II;OUT:ROOT
sa'anjoKdiit_hlep	sa'anjoK	X;IN:ROOT;IN:3PL.II;OUT:ROOT
baGadilim_wilda	baGadilda	X;IN:ROOT;IN:ATTR;OUT:ROOT;OUT:3PL
sinhunt_laXyibit	sinhunt	X;IN:ROOT;IN:3.II;OUT:ROOT;OUT:SX
diha'w_Gost	daha'wt	X;IN:ROOT;OUT:ROOT;OUT:3.II
hlo'ot_jaXjoGo'm	hlo'o'm	X;IN:ROOT;IN:PL;IN:SX;OUT:ROOT;OUT:PL;OUT:1PL.II
joGat_Ganaa'wi'y	joGo'y	X;IN:ROOT;IN:SX;OUT:ROOT;OUT:1SG.II
laXyibit_maa'yi'm	laXyibi'm	X;IN:ROOT;IN:SX;OUT:ROOT;OUT:1PL.II
algaXa'm_weli	algaX	X;IN:ROOT;IN:1PL.II;OUT:ROOT
gett_Galts'ep	get	X;IN:ROOT;IN:3.II;OUT:ROOT
huutdiit_mismesxw	huut	X;IN:ROOT;IN:PL;IN:3PL.II;OUT:ROOT;OUT:PL
win_didi'ydiit	wildiit	X;IN:ROOT;IN:2SG.II;OUT:ROOT;OUT:3PL.II
t'aat_hapdiit	wendiit	X;IN:ROOT;IN:3.II;OUT:ROOT;OUT:PL;OUT:3PL.II
wani'm_jaXjoGo'm	weni'm	X;IN:ROOT;IN:PL;IN:1PL.II;OUT:ROOT;OUT:PL;OUT:1PL.II
wat_Xpts'ewi'y	we'y	X;IN:ROOT;IN:3.II;OUT:ROOT;OUT:1SG.II
dexwt_hanaK't	'nu'wt	X;IN:ROOT;IN:PL;IN:3.II;OUT:ROOT;OUT:3.II
loo_Gaseexwt	gyoot	X;IN:ROOT;IN:PL;OUT:ROOT;OUT:3.II
GaGoott_al'alGalt	GaGoott	X;IN:ROOT;IN:PL;IN:3.II;OUT:ROOT;OUT:PL;OUT:3.II
ksimaas_yuxwdiit	ksimaasdiit	X;IN:ROOT;OUT:ROOT;OUT:3PL.II
K'ojam_hapt	K'otst	X;IN:ROOT;IN:ATTR;OUT:ROOT;OUT:3.II
Galts'ebi'y_'nii'wadiit	Galts'epdiit	X;IN:ROOT;IN:1SG.II;OUT:ROOT;OUT:3PL.II
'mast_hlgim	limXsim	X;IN:ROOT;IN:3.II;OUT:ROOT;OUT:PL;OUT:ATTR
t'aan_dohot	wanit	X;IN:ROOT;IN:2SG.II;OUT:ROOT;OUT:PL;OUT:SX
hashetsdiit_doGot	hashejit	X;IN:ROOT;IN:PL;IN:3PL.II;OUT:ROOT;OUT:PL;OUT:TR;OUT:3.II
ga'adiit_Ganaa'wi'y	ga'a'y	X;IN:ROOT;IN:3PL.II;OUT:ROOT;OUT:1SG.II
gidaX_daa'whldiit	GedaXdiit	X;IN:ROOT;OUT:ROOT;OUT:3PL.II
hlimoot_ts'ep	hlimoo	X;IN:ROOT;IN:3.II;OUT:ROOT
wani'm_wanit	went	X;IN:ROOT;IN:PL;IN:1PL.II;OUT:ROOT;OUT:PL;OUT:SX
wen_sisipt	went	X;IN:ROOT;IN:PL;OUT:ROOT;OUT:PL;OUT:3.II
lukwt_giihl	lukw	X;IN:ROOT;IN:3.II;OUT:ROOT
diyeet_Ge'n	diyee	X;IN:ROOT;IN:3.II;OUT:ROOT
gidaXat_anooK	gidaX	X;IN:ROOT;IN:TR;IN:3.II;OUT:ROOT
kw'esin_kw'esini'y	kw'esini'y	X;IN:ROOT;OUT:ROOT;OUT:TR;OUT:1SG.II
hasaKdiit_sGat'akw	hasaK	X;IN:ROOT;IN:3PL.II;OUT:ROOT
hlguuhlxum_nigwoodi'y	hlguuhlxwi'yaa	X;IN:ROOT;IN:ATTR;OUT:ROOT;OUT:1SG.II
limXsim_saks	limXs	X;IN:ROOT;IN:PL;IN:ATTR;OUT:ROOT;OUT:PL
woK'diit_Xbaa'w	woK'	X;IN:ROOT;IN:3PL.II;OUT:ROOT
win_wilda	wilda	X;IN:ROOT;IN:2SG.II;OUT:ROOT;OUT:3PL
baGadilt_wilda	baGadilda	X;IN:ROOT;IN:SX;OUT:ROOT;OUT:3PL
'nakw_doK	'niiluxw	X;IN:ROOT;OUT:ROOT;OUT:PL
aluugiget_dewdew	aluugiget	X;IN:ROOT;IN:PL;OUT:ROOT;OUT:PL
luuhitxwGootdiit_sa'anjapdiit	luuhitxwGootdiit	X;IN:ROOT;IN:3PL.II;OUT:ROOT;OUT:3PL.II
yuxwt_'mootxwit	yuwit	X;IN:ROOT;IN:3.II;OUT:ROOT;OUT:TR;OUT:3.II
hahle'lst_alisxu'm	hahle'lsdi'm	X;IN:ROOT;OUT:ROOT;OUT:1PL.II
gwiiseeKt_yuwit	guseeGat	X;IN:ROOT;IN:PL;IN:3.II;OUT:ROOT;OUT:TR;OUT:3.II
hlguuhlxwi'y_maK	hlguuhlxw	X;IN:ROOT;IN:1SG.II;OUT:ROOT
maK_doXdiit	t'ehldiit	X;IN:ROOT;OUT:ROOT;OUT:PL;OUT:3PL.II
sekst_xsiga'a	daa'whl	X;IN:ROOT;IN:PL;IN:3.II;OUT:ROOT
saks_hlo'ot	seksit	X;IN:ROOT;IN:PL;OUT:ROOT;OUT:PL;OUT:SX
aamit_dildilsit	am'amit	X;IN:ROOT;IN:SX;OUT:ROOT;OUT:PL;OUT:SX
jaXjoGot_'witxwi'y	joGo'y	X;IN:ROOT;IN:PL;IN:SX;OUT:ROOT;OUT:1SG.II
ii'wxwt_'maXs	get	X;IN:ROOT;IN:PL;OUT:ROOT
gwilat_ts'atxw	gwila	X;IN:ROOT;IN:3.II;OUT:ROOT
ayooK_gidaXt	ayooKt	X;IN:ROOT;OUT:ROOT;OUT:3.II
hooyit_wilaayi'y	hooyi'y	X;IN:ROOT;IN:TR;IN:3.II;OUT:ROOT;OUT:TR;OUT:1SG.II
daXgadim_k'idaa'wt	daXgett	X;IN:ROOT;IN:ATTR;OUT:ROOT;OUT:3.II
naX'ni_yuwit	naX'niyit	X;IN:ROOT;OUT:ROOT;OUT:TR;OUT:3.II
gitxs_ts'epdiit	gitxsdiit	X;IN:ROOT;OUT:ROOT;OUT:3PL.II
ts'epdiit_mihlt	ts'ept	X;IN:ROOT;IN:3PL.II;OUT:ROOT;OUT:3.II
hanaK'_ha'niilaahl	haanaK'	X;IN:ROOT;OUT:ROOT;OUT:PL
'mesi'y_meeXt	'mast	X;IN:ROOT;IN:1SG.II;OUT:ROOT;OUT:3.II
'nu'wdiit_jaXjoKdiit	dexwdiit	X;IN:ROOT;IN:3PL.II;OUT:ROOT;OUT:PL;OUT:3PL.II
daa'whldiit_'maXs	daa'whl	X;IN:ROOT;IN:3PL.II;OUT:ROOT
gyoot_saXdoXdiit	loodiit	X;IN:ROOT;IN:3.II;OUT:ROOT;OUT:PL;OUT:3PL.II
lem_ayooK	gem	X;IN:ROOT;IN:PL;OUT:ROOT
wandiit_eejam	t'aam	X;IN:ROOT;IN:PL;IN:3PL.II;OUT:ROOT;OUT:ATTR
doKdiit_yuuhlimX	guu	X;IN:ROOT;IN:PL;IN:3PL.II;OUT:ROOT
amet_a'laXt	amet	X;IN:ROOT;IN:3.II;OUT:ROOT;OUT:3.II
helda_anjapt	heltt	X;IN:ROOT;IN:ATTR;OUT:ROOT;OUT:3.II
huudini'm_se'e	k'eeKin	X;IN:ROOT;IN:PL;IN:TR;IN:1PL.II;OUT:ROOT
gitxs_dohot	gigitxsit	X;IN:ROOT;OUT:ROOT;OUT:PL;OUT:SX
daa'whldiit_loot	sekst	X;IN:ROOT;IN:3PL.II;OUT:ROOT;OUT:PL;OUT:3.II
ixsdat_adaawK	iksde	X;IN:ROOT;IN:3.II;OUT:ROOT
kw'esin_daa'whlt	kw'asint	X;IN:ROOT;OUT:ROOT;OUT:3.II
saGaytGootda_wilda	saGaytGootda	X;IN:ROOT;IN:3PL;OUT:ROOT;OUT:3PL
bekwt_bagu'm	bagu'm	X;IN:ROOT;IN:PL;IN:3.II;OUT:ROOT;OUT:PL;OUT:1PL.II
bekw_laXyibit	'witxwit	X;IN:ROOT;IN:PL;OUT:ROOT;OUT:SX
t'aa_t'ihlxum	t'aam	X;IN:ROOT;OUT:ROOT;OUT:ATTR
sbaGaytGanGan_gilbil	sbaaytGan	X;IN:ROOT;IN:PL;OUT:ROOT
Goldiit_dewdew	Gol	X;IN:ROOT;IN:PL;IN:3PL.II;OUT:ROOT;OUT:PL
jep_luuwendindiit	jipjepdiit	X;IN:ROOT;OUT:ROOT;OUT:PL;OUT:3PL.II
weli_limXsim	huwelixim	X;IN:ROOT;OUT:ROOT;OUT:PL;OUT:ATTR
hasaKdiit_anbisxwit	hasaGat	X;IN:ROOT;IN:3PL.II;OUT:ROOT;OUT:SX
jepdiit_t'ehldiit	jipjepdiit	X;IN:ROOT;IN:3PL.II;OUT:ROOT;OUT:PL;OUT:3PL.II
hlimoo'ldiit_simaa'y	hlimoo'lt	X;IN:ROOT;IN:3PL.II;OUT:ROOT
yee_jaXjoKdiit	hlo'odiit	X;IN:ROOT;OUT:ROOT;OUT:PL;OUT:3PL.II
k'eeGani'm_gu	k'eeKin	X;IN:ROOT;IN:1PL.II;OUT:ROOT
waatxwdiit_'witxw	waatxw	X;IN:ROOT;IN:3PL.II;OUT:ROOT
hlguuhlxwi'yaa_aXalgaX	hlguuhlxw	X;IN:ROOT;IN:1SG.II;OUT:ROOT
want_luujoK	t'aa	X;IN:ROOT;IN:PL;IN:SX;OUT:ROOT
hlgim_tXooGandiit	hlgidiit	X;IN:ROOT;IN:PL;IN:ATTR;OUT:ROOT;OUT:PL;OUT:3PL.II
hets_yee'm	hiji'm	X;IN:ROOT;OUT:ROOT;OUT:1PL.II
da'aKhlxwin_'win	da'aKhlxw	X;IN:ROOT;IN:2SG.II;OUT:ROOT
Goli'm_al'alGalt	Golt	X;IN:ROOT;IN:PL;IN:1PL.II;OUT:ROOT;OUT:PL;OUT:3.II
hlimooyi'm_giikwdiit	hlimoodiit	X;IN:ROOT;IN:TR;IN:1PL.II;OUT:ROOT;OUT:3PL.II
nibibi'y_dukhlinX	nibip	X;IN:ROOT;IN:1SG.II;OUT:ROOT
gubi'y_jemdiit	gupdiit	X;IN:ROOT;IN:TR;IN:1SG.II;OUT:ROOT;OUT:3PL.II
jebi'y_lukwdiit	jepdiit	X;IN:ROOT;IN:TR;IN:1SG.II;OUT:ROOT;OUT:3PL.II
simgiget_huwilaa	simgiget	X;IN:ROOT;IN:PL;OUT:ROOT;OUT:PL
waatxwt_hlguts'uus	waatxw	X;IN:ROOT;IN:3.II;OUT:ROOT
tK'alhuksindiit_is	??tK'alhuksin	X;IN:ROOT;IN:3PL.II;OUT:ROOT
yee'm_bitxwit	yeet	X;IN:ROOT;IN:1PL.II;OUT:ROOT;OUT:SX
begu'm_dexwdiit	bekwdiit	X;IN:ROOT;IN:PL;IN:1PL.II;OUT:ROOT;OUT:PL;OUT:3PL.II
ga'a'm_loodiit	gitga'adiit	X;IN:ROOT;IN:TR;IN:1PL.II;OUT:ROOT;OUT:PL;OUT:3PL.II
gemgim_iksdedint	gemkt	X;IN:ROOT;IN:ATTR;OUT:ROOT;OUT:3.II
wiyitxwt_gigeeni	wiyitxw	X;IN:ROOT;IN:3.II;OUT:ROOT
sdil_Ge'ndiit	sdildiit	X;IN:ROOT;OUT:ROOT;OUT:3PL.II
'witxwt_loot	bekwt	X;IN:ROOT;IN:3.II;OUT:ROOT;OUT:PL;OUT:3.II
wen_k'i'yt	t'aat	X;IN:ROOT;IN:PL;OUT:ROOT;OUT:SX
waatxwit_yukw	waatxw	X;IN:ROOT;IN:SX;OUT:ROOT
wakt_saGaytGootin	wa	X;IN:ROOT;IN:3.II;OUT:ROOT
went_yeet	t'aat	X;IN:ROOT;IN:PL;IN:3.II;OUT:ROOT;OUT:SX
doXdiit_gigitxsit	dohot	X;IN:ROOT;IN:PL;IN:3PL.II;OUT:ROOT;OUT:PL;OUT:SX
ha'wdiit_Galts'ep	ha'w	X;IN:ROOT;IN:3PL.II;OUT:ROOT
yuxwt_sityeewit	yuxwit	X;IN:ROOT;IN:3.II;OUT:ROOT;OUT:TR;OUT:3.II
wilaayi'y_luuyuxw	halaa	X;IN:ROOT;IN:TR;IN:1SG.II;OUT:ROOT
jebi'y_baKdiit	japdiit	X;IN:ROOT;IN:TR;IN:1SG.II;OUT:ROOT;OUT:3PL.II
baXa'y_k'eeKin	baX	X;IN:ROOT;IN:1SG.II;OUT:ROOT
'nu'w_t'ahl	dexw	X;IN:ROOT;OUT:ROOT;OUT:PL
bitxwit_gi'namhlxum	bitxum	X;IN:ROOT;IN:SX;OUT:ROOT;OUT:ATTR
gedim_a'laX	gat	X;IN:ROOT;IN:ATTR;OUT:ROOT
ts'ept_ayukwsim	ts'ebim	X;IN:ROOT;IN:3.II;OUT:ROOT;OUT:ATTR
GedaXdiit_hlimoo'ltt	gidaXt	X;IN:ROOT;IN:3PL.II;OUT:ROOT;OUT:3.II
da'aKhlxwi'y_hilt	da'aKhlxw	X;IN:ROOT;IN:1SG.II;OUT:ROOT
wildiit_hap	wil	X;IN:ROOT;IN:3PL.II;OUT:ROOT
Goli'm_liksgetin	baX	X;IN:ROOT;IN:PL;IN:1PL.II;OUT:ROOT
hidint_loK	hitin	X;IN:ROOT;IN:3.II;OUT:ROOT
wisi'm_ga'at	wilt	X;IN:ROOT;IN:2PL.II;OUT:ROOT;OUT:3.II
baK_saK'apdiit	baKdiit	X;IN:ROOT;OUT:ROOT;OUT:3PL.II
wen_doXdiit	wendiit	X;IN:ROOT;IN:PL;OUT:ROOT;OUT:PL;OUT:3PL.II
t'ist_anbisxwit	t'isit	X;IN:ROOT;IN:3.II;OUT:ROOT;OUT:SX
jaXjoKt_gidaXa'm	joGo'm	X;IN:ROOT;IN:PL;IN:3.II;OUT:ROOT;OUT:1PL.II
baGa'm_baGa'y	baGa'y	X;IN:ROOT;IN:TR;IN:1PL.II;OUT:ROOT;OUT:TR;OUT:1SG.II
t'aham_liluxwst	t'aXt	X;IN:ROOT;IN:ATTR;OUT:ROOT;OUT:3.II
laXyibi'm_maGoont	laXyipt	X;IN:ROOT;IN:1PL.II;OUT:ROOT;OUT:3.II
seksdiit_gigi'ydiit	saksdiit	X;IN:ROOT;IN:PL;IN:3PL.II;OUT:ROOT;OUT:PL;OUT:3PL.II
hlguuhlxum_hisyetsdiit	hlgidiit	X;IN:ROOT;IN:ATTR;OUT:ROOT;OUT:PL;OUT:3PL.II
sdik'eegwin_ky'ul	sdik'eekw	X;IN:ROOT;IN:2SG.II;OUT:ROOT
t'is_ky'ult	t'isit	X;IN:ROOT;OUT:ROOT;OUT:SX
huutdiit_jaXjoGo'm	huudi'm	X;IN:ROOT;IN:PL;IN:3PL.II;OUT:ROOT;OUT:PL;OUT:1PL.II
heldit_baX	helt	X;IN:ROOT;IN:SX;OUT:ROOT
bekwt_hisyetst	bekwt	X;IN:ROOT;IN:PL;IN:3.II;OUT:ROOT;OUT:PL;OUT:3.II
GaGoott_hishalaagaXdiit	GaGootdiit	X;IN:ROOT;IN:PL;IN:3.II;OUT:ROOT;OUT:PL;OUT:3PL.II
tK'esxwt_dulbin	tK'esxw	X;IN:ROOT;IN:3.II;OUT:ROOT
heltda_ansdo'ot	heltt	X;IN:ROOT;IN:3PL;OUT:ROOT;OUT:3.II
al'alGaldiit_del	'alGal	X;IN:ROOT;IN:PL;IN:3PL.II;OUT:ROOT
daa'wihlt_lekwdiit	daa'whldiit	X;IN:ROOT;IN:3.II;OUT:ROOT;OUT:3PL.II
silim_smaxdiit	silimxdiit	X;IN:ROOT;OUT:ROOT;OUT:3PL.II
'witxwit_hlk'uba	bekw	X;IN:ROOT;IN:SX;OUT:ROOT;OUT:PL
went_hlgidiit	wendiit	X;IN:ROOT;IN:PL;IN:SX;OUT:ROOT;OUT:PL;OUT:3PL.II
heet_win	hen	X;IN:ROOT;IN:SX;OUT:ROOT;OUT:2SG.II
hahle'lsdi'm_t'amdiit	hahle'lsdiit	X;IN:ROOT;IN:1PL.II;OUT:ROOT;OUT:3PL.II
naX'nit_sba'aKhlxwt	Xa'nit	X;IN:ROOT;IN:3.II;OUT:ROOT;OUT:3.II
dexwdiit_dildilsit	dexwit	X;IN:ROOT;IN:PL;IN:3PL.II;OUT:ROOT;OUT:PL;OUT:SX
'witxwi'y_hlaahlaXtt	bekwt	X;IN:ROOT;IN:1SG.II;OUT:ROOT;OUT:PL;OUT:3.II
gidaXat_baGadili'm	gidaXa'm	X;IN:ROOT;IN:TR;IN:3.II;OUT:ROOT;OUT:1PL.II
wa_Galts'ebi'y	wegi'y	X;IN:ROOT;OUT:ROOT;OUT:1SG.II
t'ist_betl'a	t'isim	X;IN:ROOT;IN:3.II;OUT:ROOT;OUT:ATTR
lidindiit_sGa'wadiit	hedindiit	X;IN:ROOT;IN:PL;IN:3PL.II;OUT:ROOT;OUT:3PL.II
simgiget_gidiidoK	simgigat	X;IN:ROOT;IN:PL;OUT:ROOT;OUT:PL
baGadil_saGaytGootda	baGadilda	X;IN:ROOT;OUT:ROOT;OUT:3PL
Golt_mis'usi'm	Goli'm	X;IN:ROOT;IN:PL;IN:3.II;OUT:ROOT;OUT:PL;OUT:1PL.II
halaaxt_'mits'indiit	halaaxdiit	X;IN:ROOT;IN:3.II;OUT:ROOT;OUT:3PL.II
guts'uusgi'y_wakt	hlguts'uusxt	X;IN:ROOT;IN:1SG.II;OUT:ROOT;OUT:3.II
heet_niye'e'y	he'y	X;IN:ROOT;IN:SX;OUT:ROOT;OUT:1SG.II
jept_t'agi'y	jabi'y	X;IN:ROOT;IN:3.II;OUT:ROOT;OUT:TR;OUT:1SG.II
luuhitxwGoot_saalukwdiit	luuhitxwGootdiit	X;IN:ROOT;OUT:ROOT;OUT:3PL.II
baXa'y_doXdiit	Goldiit	X;IN:ROOT;IN:1SG.II;OUT:ROOT;OUT:PL;OUT:3PL.II
hlguts'uusgi'y_xsawi'y	guts'uusgi'y	X;IN:ROOT;IN:1SG.II;OUT:ROOT;OUT:1SG.II
ga'a'y_luuwendindiit	gitga'adiit	X;IN:ROOT;IN:TR;IN:1SG.II;OUT:ROOT;OUT:PL;OUT:3PL.II
we_hasaGa'y	we'y	X;IN:ROOT;OUT:ROOT;OUT:1SG.II
dexwit_hap	dexw	X;IN:ROOT;IN:PL;IN:SX;OUT:ROOT;OUT:PL
'niiluxw_ga'at	'nekwt	X;IN:ROOT;IN:PL;OUT:ROOT;OUT:3.II
saGaytwenda_saGaytwenda	saGaytwenda	X;IN:ROOT;IN:PL;IN:3PL;OUT:ROOT;OUT:PL;OUT:3PL
baGadilt_daXgadim	baGadilim	X;IN:ROOT;IN:SX;OUT:ROOT;OUT:ATTR
liksgedim_gemgim	liksgedim	X;IN:ROOT;IN:ATTR;OUT:ROOT;OUT:ATTR
gipaykwdiit_Gost	gipaykwt	X;IN:ROOT;IN:3PL.II;OUT:ROOT;OUT:3.II
K'ay'mes_nooGa'y	K'ay'mesi'y	X;IN:ROOT;OUT:ROOT;OUT:1SG.II
sise'en_Gan	se'e	X;IN:ROOT;IN:PL;IN:2SG.II;OUT:ROOT
'maXsim_saGaytGoodint	'maXst	X;IN:ROOT;IN:ATTR;OUT:ROOT;OUT:3.II
went_iwit	t'aat	X;IN:ROOT;IN:PL;IN:SX;OUT:ROOT;OUT:SX
t'aan_jaXjoKdiit	wendiit	X;IN:ROOT;IN:2SG.II;OUT:ROOT;OUT:PL;OUT:3PL.II
hogaXdiit_k'i'yt	hugwaXt	X;IN:ROOT;IN:3PL.II;OUT:ROOT;OUT:3.II
saalukw_guslisdiit	saalukwdiit	X;IN:ROOT;OUT:ROOT;OUT:3PL.II
ha'u'm_amhalaytt	ha'wt	X;IN:ROOT;IN:1PL.II;OUT:ROOT;OUT:3.II
iksdet_ubint	ixsdat	X;IN:ROOT;IN:3.II;OUT:ROOT;OUT:3.II
k'eeKin_he'm	k'eeGani'm	X;IN:ROOT;OUT:ROOT;OUT:1PL.II
gitxt_wil'naat'ahldiit	gitxsdiit	X;IN:ROOT;IN:3.II;OUT:ROOT;OUT:3PL.II
GaGoott_hahlo'ot	GaGoott	X;IN:ROOT;IN:PL;IN:3.II;OUT:ROOT;OUT:PL;OUT:3.II
ayukwsdiit_amhe	ayukws	X;IN:ROOT;IN:3PL.II;OUT:ROOT
yuxw_maKt	yuxwt	X;IN:ROOT;OUT:ROOT;OUT:3.II
bekwt_hahlo'ot	bekwt	X;IN:ROOT;IN:PL;IN:3.II;OUT:ROOT;OUT:PL;OUT:3.II
silim_hlXo'odiit	salimxdiit	X;IN:ROOT;OUT:ROOT;OUT:3PL.II
neks_heldim	neksim	X;IN:ROOT;OUT:ROOT;OUT:ATTR
yets_hisyetst	hisyetst	X;IN:ROOT;OUT:ROOT;OUT:PL;OUT:3.II
went_luuwent	want	X;IN:ROOT;IN:PL;IN:3.II;OUT:ROOT;OUT:PL;OUT:3.II
nigwootdiit_he'y	nigwoodi'y	X;IN:ROOT;IN:3PL.II;OUT:ROOT;OUT:1SG.II
baGa'y_helt	baK	X;IN:ROOT;IN:TR;IN:1SG.II;OUT:ROOT
saalukwdiit_anooK	saalukw	X;IN:ROOT;IN:3PL.II;OUT:ROOT
smaxdiit_nakst	smaxt	X;IN:ROOT;IN:3PL.II;OUT:ROOT;OUT:3.II
hahle'lst_ts'ak't	hahle'lst	X;IN:ROOT;OUT:ROOT;OUT:3.II
Gabii_gwelk'ujaXt	Gabiit	X;IN:ROOT;OUT:ROOT;OUT:3.II
yuwi'y_ban	yuxw	X;IN:ROOT;IN:TR;IN:1SG.II;OUT:ROOT
hahla'ljit_Xmaa'yi'm	hahle'lsdi'm	X;IN:ROOT;IN:SX;OUT:ROOT;OUT:1PL.II
doXt_ga'at	sgit	X;IN:ROOT;IN:PL;IN:3.II;OUT:ROOT;OUT:3.II
hahla'lsdi'y_sisatxwdiit	hahle'lsdiit	X;IN:ROOT;IN:1SG.II;OUT:ROOT;OUT:3PL.II
Goott_gipaykwt	GaGoott	X;IN:ROOT;IN:3.II;OUT:ROOT;OUT:PL;OUT:3.II
wendiit_tXooK	wan	X;IN:ROOT;IN:PL;IN:3PL.II;OUT:ROOT;OUT:PL
helt_heldit	heldit	X;IN:ROOT;OUT:ROOT;OUT:SX
jat_ga'at	jehlit	X;IN:ROOT;IN:3.II;OUT:ROOT;OUT:TR;OUT:3.II
se'et_hoo	se'e	X;IN:ROOT;IN:3.II;OUT:ROOT
loK_gehlim	loGa	X;IN:ROOT;OUT:ROOT;OUT:ATTR
miindiit_jiip	miin	X;IN:ROOT;IN:3PL.II;OUT:ROOT
ga'a'y_hit'int	ga'at	X;IN:ROOT;IN:1SG.II;OUT:ROOT;OUT:TR;OUT:3.II
ts'uus_gwalgwa	ts'uusxim	X;IN:ROOT;OUT:ROOT;OUT:ATTR
saksit_luutK'alno'o	daa'whl	X;IN:ROOT;IN:PL;IN:SX;OUT:ROOT
yuxwt_ky'ul	yuxw	X;IN:ROOT;IN:3.II;OUT:ROOT
kwsdinsit_gyoot	kwsdinst	X;IN:ROOT;IN:SX;OUT:ROOT;OUT:3.II
baasxi'y_t'ayksxw	baas	X;IN:ROOT;IN:TR;IN:1SG.II;OUT:ROOT
hasaKt_dils	hasaK	X;IN:ROOT;IN:3.II;OUT:ROOT
wildigitxwit_dekhldiit	wildigitxwdiit	X;IN:ROOT;IN:SX;OUT:ROOT;OUT:3PL.II
baKt_gidaX	baK	X;IN:ROOT;IN:3.II;OUT:ROOT
bekwt_dibekwt	bekwt	X;IN:ROOT;IN:PL;IN:3.II;OUT:ROOT;OUT:PL;OUT:3.II
t'aXdiit_daa'whl	t'aX	X;IN:ROOT;IN:3PL.II;OUT:ROOT
wilaayit_dit'e'ldiit	wilaaxdiit	X;IN:ROOT;IN:TR;IN:3.II;OUT:ROOT;OUT:3PL.II
wilt_gwila'm	wili'm	X;IN:ROOT;IN:3.II;OUT:ROOT;OUT:1PL.II
dohot_GaGoott	doXt	X;IN:ROOT;IN:PL;IN:SX;OUT:ROOT;OUT:PL;OUT:3.II
'nu'wit_lixleyit	dexwit	X;IN:ROOT;IN:SX;OUT:ROOT;OUT:PL;OUT:SX
hlguuhlxwi'yaa_disekst	hlgit	X;IN:ROOT;IN:1SG.II;OUT:ROOT;OUT:PL;OUT:3.II
ha'niiGootdiit_ha'wi'y	ha'niiGoodi'y	X;IN:ROOT;IN:3PL.II;OUT:ROOT;OUT:1SG.II
GaGoott_wegi'y	Goodi'y	X;IN:ROOT;IN:PL;IN:3.II;OUT:ROOT;OUT:1SG.II
nakst_ts'ebim	neksim	X;IN:ROOT;IN:3.II;OUT:ROOT;OUT:ATTR
hlguts'uusgi'm_algaXa'y	hlguts'uusgi'y	X;IN:ROOT;IN:1PL.II;OUT:ROOT;OUT:1SG.II
hahla'lsdi'm_smaxt	hahle'lst	X;IN:ROOT;IN:1PL.II;OUT:ROOT;OUT:3.II
wanit_went	want	X;IN:ROOT;IN:PL;IN:SX;OUT:ROOT;OUT:PL;OUT:3.II
laahl_nigwoodi'y	giihli'y	X;IN:ROOT;IN:PL;OUT:ROOT;OUT:1SG.II
jixjiksindiit_mo'on	jiksin	X;IN:ROOT;IN:PL;IN:3PL.II;OUT:ROOT
'nu'wt_olaX	'nu'w	X;IN:ROOT;IN:SX;OUT:ROOT
anhee'y_is	anhe	X;IN:ROOT;IN:1SG.II;OUT:ROOT
bekwt_aX'algaGa'y	'witxwi'y	X;IN:ROOT;IN:PL;IN:3.II;OUT:ROOT;OUT:1SG.II
noXt_looy	noX	X;IN:ROOT;IN:3.II;OUT:ROOT
yuxwt_da'witxwit	yuxwit	X;IN:ROOT;IN:3.II;OUT:ROOT;OUT:TR;OUT:3.II
lem_Gant	gemkt	X;IN:ROOT;IN:PL;OUT:ROOT;OUT:3.II
jat_jisjahlit	jisjahlit	X;IN:ROOT;IN:3.II;OUT:ROOT;OUT:PL;OUT:TR;OUT:3.II
am'amt_tXalpXat	aamit	X;IN:ROOT;IN:PL;IN:3.II;OUT:ROOT;OUT:SX
baGadil_'nagwit	baGadilt	X;IN:ROOT;OUT:ROOT;OUT:SX
hlgi'y_huwelixim	hlgim	X;IN:ROOT;IN:PL;IN:1SG.II;OUT:ROOT;OUT:PL;OUT:ATTR
wet_waatxwt	wat	X;IN:ROOT;IN:3.II;OUT:ROOT;OUT:3.II
bekwt_t'ipXaadit	'witxwit	X;IN:ROOT;IN:PL;IN:3.II;OUT:ROOT;OUT:SX
gwilan_Xde	gwila	X;IN:ROOT;IN:2SG.II;OUT:ROOT
sgett_hlguhlguts'uuskts'uus	sget	X;IN:ROOT;IN:3.II;OUT:ROOT
dibekwt_ts'iip	dikw'itxw	X;IN:ROOT;IN:PL;IN:3.II;OUT:ROOT
uu'w_hanwilaakwt	uu'wit	X;IN:ROOT;OUT:ROOT;OUT:3.II
bakw_sekst	bekwt	X;IN:ROOT;IN:PL;OUT:ROOT;OUT:PL;OUT:3.II
wildiit_nooGa'y	wili'y	X;IN:ROOT;IN:3PL.II;OUT:ROOT;OUT:1SG.II
hoo_ga'at	hooyit	X;IN:ROOT;OUT:ROOT;OUT:TR;OUT:3.II
Go'odiit_liluxwsisi'm	Go'osi'm	X;IN:ROOT;IN:3PL.II;OUT:ROOT;OUT:2PL.II
gwilat_jemdiit	gwiladiit	X;IN:ROOT;IN:3.II;OUT:ROOT;OUT:3PL.II
sgidiit_saXdoXdiit	doXdiit	X;IN:ROOT;IN:3PL.II;OUT:ROOT;OUT:PL;OUT:3PL.II
'witxwit_gidiidoKt	bekwt	X;IN:ROOT;IN:SX;OUT:ROOT;OUT:PL;OUT:3.II
t'aa_Gol	wen	X;IN:ROOT;OUT:ROOT;OUT:PL
huksin_t'is	huks	X;IN:ROOT;IN:2SG.II;OUT:ROOT
anooGo'm_tXo'odiit	anooKdiit	X;IN:ROOT;IN:1PL.II;OUT:ROOT;OUT:3PL.II
sgett_gemkt	sgett	X;IN:ROOT;IN:3.II;OUT:ROOT;OUT:3.II
hal'algaXt_hasbagyoo	algaX	X;IN:ROOT;IN:PL;IN:3.II;OUT:ROOT
heldit_baGadilda	heltda	X;IN:ROOT;IN:SX;OUT:ROOT;OUT:3PL
hlo'ot_tK'at	yeet	X;IN:ROOT;IN:PL;IN:3.II;OUT:ROOT;OUT:3.II
guut_huudini'm	doGo'm	X;IN:ROOT;IN:3.II;OUT:ROOT;OUT:PL;OUT:TR;OUT:1PL.II
he'm_jayeehlt	het	X;IN:ROOT;IN:1PL.II;OUT:ROOT;OUT:3.II
gyoo_baKt	gyoot	X;IN:ROOT;OUT:ROOT;OUT:3.II
want_dildilsdiit	wendiit	X;IN:ROOT;IN:PL;IN:3.II;OUT:ROOT;OUT:PL;OUT:3PL.II
isi'm_da'aKhlxwin	isin	X;IN:ROOT;IN:1PL.II;OUT:ROOT;OUT:2SG.II
'witxw_t'aat	'witxwit	X;IN:ROOT;OUT:ROOT;OUT:SX
jabi'y_haboo'lt	jept	X;IN:ROOT;IN:TR;IN:1SG.II;OUT:ROOT;OUT:3.II
t'aa_al'alGalt	want	X;IN:ROOT;OUT:ROOT;OUT:PL;OUT:3.II
gipaykw_simihldiit	gipaykwdiit	X;IN:ROOT;IN:PL;OUT:ROOT;OUT:3PL.II
daXgigetdiit_al'alGaldiit	daXgigetdiit	X;IN:ROOT;IN:PL;IN:3PL.II;OUT:ROOT;OUT:PL;OUT:3PL.II
seks_joKdiit	daa'whldiit	X;IN:ROOT;IN:PL;OUT:ROOT;OUT:3PL.II
hlo'ot_yimt	yeet	X;IN:ROOT;IN:PL;IN:SX;OUT:ROOT;OUT:3.II
hlo'o'm_hlo'ot	hlo'ot	X;IN:ROOT;IN:PL;IN:1PL.II;OUT:ROOT;OUT:PL;OUT:SX
lidint_silkwt	hidint	X;IN:ROOT;IN:PL;IN:3.II;OUT:ROOT;OUT:3.II
hooyi'y_amhalayt	hoo	X;IN:ROOT;IN:TR;IN:1SG.II;OUT:ROOT
ha'wit_dukhlinXt	ha'wt	X;IN:ROOT;IN:3.II;OUT:ROOT;OUT:3.II
'witxwit_xsawi'y	'witxwi'y	X;IN:ROOT;IN:SX;OUT:ROOT;OUT:1SG.II
laXyibi'm_'witxw	laXyip	X;IN:ROOT;IN:1PL.II;OUT:ROOT
bitxwit_k'uuhl;	bitxw	X;IN:ROOT;IN:SX;OUT:ROOT
didilsdi'm_dukhlinX	dils	X;IN:ROOT;IN:PL;IN:1PL.II;OUT:ROOT
gidiidoK_laahldiit	gidiidoKdiit	X;IN:ROOT;IN:PL;OUT:ROOT;OUT:PL;OUT:3PL.II
'witxwt_aliisxu'm	bagu'm	X;IN:ROOT;IN:3.II;OUT:ROOT;OUT:PL;OUT:1PL.II
t'ilXo'odiit_ts'e'li'y	t'ilXoo'y	X;IN:ROOT;IN:3PL.II;OUT:ROOT;OUT:1SG.II
di'witxwdiit_dibegwit	dibegwit	X;IN:ROOT;IN:3PL.II;OUT:ROOT;OUT:PL;OUT:TR;OUT:3.II
sgidiit_K'ap	sgi	X;IN:ROOT;IN:3PL.II;OUT:ROOT
doKt_yukw	guu	X;IN:ROOT;IN:PL;IN:3.II;OUT:ROOT
Galjipts'ep_sa'anlayt'ixdiit	Galts'epdiit	X;IN:ROOT;IN:PL;OUT:ROOT;OUT:3PL.II
dibakw_hit'int	da'witxwit	X;IN:ROOT;IN:PL;OUT:ROOT;OUT:TR;OUT:3.II
hlo'ot_bekwdiit	hlo'odiit	X;IN:ROOT;IN:PL;IN:3.II;OUT:ROOT;OUT:PL;OUT:3PL.II
gidiiguu_jixjiksindiit	gidiidoKdiit	X;IN:ROOT;OUT:ROOT;OUT:PL;OUT:3PL.II
gidaXat_wildigitxwdiit	GedaXdiit	X;IN:ROOT;IN:TR;IN:3.II;OUT:ROOT;OUT:3PL.II
hashejit_hishalaagaXdiit	hashetsdiit	X;IN:ROOT;IN:PL;IN:TR;IN:3.II;OUT:ROOT;OUT:PL;OUT:3PL.II
loGa_anhe	loK	X;IN:ROOT;IN:ATTR;OUT:ROOT
wil'naat'ehlt_gwiladindiit	wil'naat'ahldiit	X;IN:ROOT;IN:3.II;OUT:ROOT;OUT:3PL.II
ha'niiGoot_ha'wi'y	ha'niiGoodi'y	X;IN:ROOT;OUT:ROOT;OUT:1SG.II
bekwt_haanaK'	bekw	X;IN:ROOT;IN:PL;IN:3.II;OUT:ROOT;OUT:PL
hogaXam_Gado'ot	hugwaXt	X;IN:ROOT;IN:ATTR;OUT:ROOT;OUT:3.II
wat_sinst	wet	X;IN:ROOT;IN:SX;OUT:ROOT;OUT:3.II
wan_gidiidoKt	went	X;IN:ROOT;IN:PL;OUT:ROOT;OUT:PL;OUT:3.II
di'witxwdiit_'niiluxw	dibekw	X;IN:ROOT;IN:3PL.II;OUT:ROOT;OUT:PL
adaawKt_hliguu	adaawK	X;IN:ROOT;IN:3.II;OUT:ROOT
niinixs_andep	neks	X;IN:ROOT;IN:PL;OUT:ROOT
jaXjoGat_luujoGat	joGat	X;IN:ROOT;IN:PL;IN:SX;OUT:ROOT;OUT:SX
hashetsdiit_ha'u'm	hiji'm	X;IN:ROOT;IN:PL;IN:3PL.II;OUT:ROOT;OUT:1PL.II
guts'uusgi'y_wili'm	hlguts'uusgi'm	X;IN:ROOT;IN:1SG.II;OUT:ROOT;OUT:1PL.II
doGo'm_ayooK	guu	X;IN:ROOT;IN:PL;IN:TR;IN:1PL.II;OUT:ROOT
gi'namit_sityeexwdiit	gi'namdiit	X;IN:ROOT;IN:TR;IN:3.II;OUT:ROOT;OUT:3PL.II
hlimoo'm_ayooKdiit	hlimoodiit	X;IN:ROOT;IN:1PL.II;OUT:ROOT;OUT:3PL.II
noXdiit_anooGo'm	noXo'm	X;IN:ROOT;IN:3PL.II;OUT:ROOT;OUT:1PL.II
t'aam_am'amt	want	X;IN:ROOT;IN:ATTR;OUT:ROOT;OUT:PL;OUT:3.II
gubit_nee	yooK	X;IN:ROOT;IN:TR;IN:3.II;OUT:ROOT
ga'a'y_ga'at	ga'at	X;IN:ROOT;IN:TR;IN:1SG.II;OUT:ROOT;OUT:TR;OUT:3.II
saGaytGoot_toosdiit	saGaytGootdiit	X;IN:ROOT;OUT:ROOT;OUT:3PL.II
didalGan_gidaXdiit	didelKdiit	X;IN:ROOT;IN:TR;IN:2SG.II;OUT:ROOT;OUT:3PL.II
'witxw_ixwt	'witxwt	X;IN:ROOT;OUT:ROOT;OUT:3.II
bent_ts'ep	ban	X;IN:ROOT;IN:3.II;OUT:ROOT
guxwin_hlamst	guxwt	X;IN:ROOT;IN:TR;IN:2SG.II;OUT:ROOT;OUT:3.II
dexwt_K'aK	'nu'w	X;IN:ROOT;IN:PL;IN:3.II;OUT:ROOT
hahla'lsdi'y_ment	hahla'ljit	X;IN:ROOT;IN:1SG.II;OUT:ROOT;OUT:SX
gubi'm_gyuksint	gubit	X;IN:ROOT;IN:TR;IN:1PL.II;OUT:ROOT;OUT:TR;OUT:3.II
Xsdaat_ts'o'oXsdiit	Xsdaadiit	X;IN:ROOT;IN:3.II;OUT:ROOT;OUT:3PL.II
daa'whlt_dildilsit	saksit	X;IN:ROOT;IN:3.II;OUT:ROOT;OUT:PL;OUT:SX
masxwt_baGadilt	masxwit	X;IN:ROOT;IN:3.II;OUT:ROOT;OUT:SX
sgit_ment	sgit	X;IN:ROOT;IN:3.II;OUT:ROOT;OUT:SX
wani'm_sisipt	went	X;IN:ROOT;IN:PL;IN:1PL.II;OUT:ROOT;OUT:PL;OUT:3.II
'nu'wt_'masxw	'nu'w	X;IN:ROOT;IN:3.II;OUT:ROOT
'nu'w_'nu'wdiit	'nu'wdiit	X;IN:ROOT;OUT:ROOT;OUT:3PL.II
gwiiseeKt_neet	guseeKt	X;IN:ROOT;IN:PL;IN:3.II;OUT:ROOT;OUT:3.II
da'aKhlxwdiit_luuyuxw	da'aKhlxw	X;IN:ROOT;IN:3PL.II;OUT:ROOT
heltdiit_haxwdekwt	heltt	X;IN:ROOT;IN:3PL.II;OUT:ROOT;OUT:3.II
hasaGat_gudets'i'y	hasaGa'y	X;IN:ROOT;IN:SX;OUT:ROOT;OUT:1SG.II
anhe_ts'ini'y	anhee'y	X;IN:ROOT;OUT:ROOT;OUT:1SG.II
hooxdiit_'nii'wa	hoo	X;IN:ROOT;IN:3PL.II;OUT:ROOT
ha'w_baGadili'm	ha'wi'm	X;IN:ROOT;OUT:ROOT;OUT:1PL.II
hlgit_ha'niiGoot	hlguuhlxw	X;IN:ROOT;IN:PL;IN:3.II;OUT:ROOT
gwalgwa_baGadilim	gwelgwa	X;IN:ROOT;IN:ATTR;OUT:ROOT;OUT:ATTR
gwilat_jiksin	gwila	X;IN:ROOT;IN:3.II;OUT:ROOT
hets_jisjahlit	hashejit	X;IN:ROOT;OUT:ROOT;OUT:PL;OUT:TR;OUT:3.II
wilaayit_ant'aahl	halaa	X;IN:ROOT;IN:TR;IN:3.II;OUT:ROOT
tK'esxw_saahlo'odiit	hapdiit	X;IN:ROOT;OUT:ROOT;OUT:PL;OUT:3PL.II
gwila_sit'aadiit	gwiladiit	X;IN:ROOT;OUT:ROOT;OUT:3PL.II
gemgim_huwilaa	lem	X;IN:ROOT;IN:ATTR;OUT:ROOT;OUT:PL
wendiit_'witxwit	t'aat	X;IN:ROOT;IN:PL;IN:3PL.II;OUT:ROOT;OUT:SX
hooxt_gi'namit	hooyit	X;IN:ROOT;IN:3.II;OUT:ROOT;OUT:TR;OUT:3.II
tXalpXu'm_luujoGat	tXalpXat	X;IN:ROOT;IN:1PL.II;OUT:ROOT;OUT:SX
t'ahl_saks	t'ehl	X;IN:ROOT;IN:PL;OUT:ROOT;OUT:PL
t'ahl_nee	maK	X;IN:ROOT;IN:PL;OUT:ROOT
gidaXa'm_ksi'wa	gidaX	X;IN:ROOT;IN:1PL.II;OUT:ROOT
ha'wt_hanaK'a'y	ha'wi'y	X;IN:ROOT;IN:3.II;OUT:ROOT;OUT:1SG.II
ga'at_Xsdaat	ga'at	X;IN:ROOT;IN:3.II;OUT:ROOT;OUT:3.II
daa'whlit_Goodat	daa'wihlt	X;IN:ROOT;IN:SX;OUT:ROOT;OUT:3.II
anooK_a'widiit	anooKdiit	X;IN:ROOT;OUT:ROOT;OUT:3PL.II
liksgedim_'wits'in	lixsgat	X;IN:ROOT;IN:ATTR;OUT:ROOT
jepdiit_yuwi'y	jebi'y	X;IN:ROOT;IN:3PL.II;OUT:ROOT;OUT:TR;OUT:1SG.II
tK'esxw_sGat'akwt	tK'esxwt	X;IN:ROOT;OUT:ROOT;OUT:3.II
want_wanit	wanit	X;IN:ROOT;IN:PL;IN:3.II;OUT:ROOT;OUT:PL;OUT:SX
gem_gwilat	gemkt	X;IN:ROOT;OUT:ROOT;OUT:3.II
hanaK't_doK	haanaK'	X;IN:ROOT;IN:3.II;OUT:ROOT;OUT:PL
ga'a'm_Goodat	ga'at	X;IN:ROOT;IN:TR;IN:1PL.II;OUT:ROOT;OUT:3.II
noXa'y_gwilan	noXon	X;IN:ROOT;IN:1SG.II;OUT:ROOT;OUT:2SG.II
giihl_hlo'o	laahl	X;IN:ROOT;OUT:ROOT;OUT:PL
noXt_da'aKhlxwin	noXon	X;IN:ROOT;IN:3.II;OUT:ROOT;OUT:2SG.II
baGadil_daXgadim	baGadilim	X;IN:ROOT;OUT:ROOT;OUT:ATTR
t'aa_woowaXa'm	wani'm	X;IN:ROOT;OUT:ROOT;OUT:PL;OUT:1PL.II
giihl_jaXjoGo'm	laahli'm	X;IN:ROOT;OUT:ROOT;OUT:PL;OUT:1PL.II
win_Go'osi'm	wilsi'm	X;IN:ROOT;IN:2SG.II;OUT:ROOT;OUT:2PL.II
sityeexwdiit_hun	sityeexw	X;IN:ROOT;IN:3PL.II;OUT:ROOT
giihli'y_Xsikst	giihlt	X;IN:ROOT;IN:1SG.II;OUT:ROOT;OUT:3.II
wilaakwdiit_ts'in	halaakw	X;IN:ROOT;IN:3PL.II;OUT:ROOT
k'eeGani'm_huudini'm	huudini'm	X;IN:ROOT;IN:1PL.II;OUT:ROOT;OUT:PL;OUT:TR;OUT:1PL.II
win_sianlayt'i	wil	X;IN:ROOT;IN:2SG.II;OUT:ROOT
hogaXt_gutXa'oo	hogaX	X;IN:ROOT;IN:3.II;OUT:ROOT
hooyit_limx'oo'y	hoo	X;IN:ROOT;IN:TR;IN:3.II;OUT:ROOT
ha'u'm_'maXst	ha'wit	X;IN:ROOT;IN:1PL.II;OUT:ROOT;OUT:3.II
neksim_Xbits'iixw	niiniks	X;IN:ROOT;IN:ATTR;OUT:ROOT;OUT:PL
doX_hlaahlaXtt	doXt	X;IN:ROOT;IN:PL;OUT:ROOT;OUT:PL;OUT:3.II
gipaykw_gwalgwa	gipaygum	X;IN:ROOT;OUT:ROOT;OUT:ATTR
saGaytGootda_heltda	saGaytGootda	X;IN:ROOT;IN:3PL;OUT:ROOT;OUT:3PL